is	í
as	á
this	thí
or	ỏ
his	hí
her	hẻ
has	há
there	thể
if	ì
been	bên
these	thế
its	ít
see	sê
did	đi
how	hơ
those	thoé
now	nơ
own	ơn
us	ú
down	dơn
here	hể
different	diferent
too	tô
thus	thú
less	les
law	lă
effect	efect
seen	sên
days	dáy
terms	tém
major	mảo
sense	sến
low	lơ
room	rôm
air	ải
term	tẻm
effects	efects
saw	să
current	curent
seems	sếm
basis	bái
turn	tủn
difficult	dificult
nor	nỏ
six	sĩ
soon	sôn
says	sáy
associated	asociated
tax	tã
issues	isues
poor	pổ
issue	isue
difference	diference
association	asociation
loss	los
town	tơn
seem	sêm
effective	efective
door	dổ
yes	yé
differences	diferences
mass	mas
ask	ák
carried	caried
laws	lắ
meet	mêt
chief	chiè
sir	sỉ
der	dẻ
born	bỏn
box	bõ
car	cả
des	dé
effort	efort
essential	esential
marriage	mariage
efforts	eforts
died	đie
sex	sẽ
gas	gá
arms	ám
hair	hải
tree	trê
trust	trút
mary	mảy
affairs	afairs
sufficient	suficient
married	maried
carry	cary
correct	corect
message	mesage
error	eror
piece	piêc
trees	trế
assessment	asessment
choose	chốe
russian	rusian
arrived	arived
miss	mis
assumed	asumed
assume	asume
assistance	asistance
affected	afected
les	lé
affect	afect
arm	ảm
assembly	asembly
bar	bả
difficulty	dificulty
tissue	tisue
mission	mision
coast	coát
chosen	choén
lies	lié
corresponding	coresponding
sets	sét
russia	rusia
difficulties	dificulties
troops	trốp
los	ló
pieces	piếc
efficiency	eficiency
queen	quên
assets	asets
narrow	narow
carrying	carying
territory	teritory
mere	mể
issued	isued
essentially	esentially
chair	chải
root	rôt
cast	cát
sons	són
assumption	asumption
narrative	narative
vast	vát
session	sesion
suffering	sufering
theme	thêm
assigned	asigned
efficient	eficient
effectively	efectively
traffic	trafic
row	rơ
lee	lê
errors	erors
vary	vảy
rooms	rốm
coffee	cofee
arrangement	arangement
moon	môn
turns	tún
axis	ái
currently	curently
towns	tớn
roots	rốt
poems	poém
suffered	sufered
usa	úa
ex	ẽ
arrangements	arangements
vessels	vesels
sees	sế
chest	chét
correlation	corelation
raw	ră
losses	loses
arranged	aranged
essay	esay
differ	difer
surrounding	surounding
assumptions	asumptions
assistant	asistant
lips	líp
trans	trán
effectiveness	efectiveness
runs	rún
honor	hổn
associations	asociations
cars	cá
sorry	sory
guess	gues
songs	sóng
arrival	arival
sufficiently	suficiently
dc	được
curriculum	curiculum
missing	mising
essence	esence
bus	bú
virus	víu
loans	loán
vessel	vesel
messages	mesages
essays	esays
suffer	sufer
mirror	miror
differential	diferential
masses	mases
dust	dút
busy	buý
coefficient	coeficient
doors	dố
assuming	asuming
harry	hary
hero	hẻo
roof	rồ
verse	vế
currency	curency
massive	masive
massachusetts	masachusetts
correspondence	corespondence
assist	asist
terrible	terible
chose	choé
lesson	leson
loose	lốe
array	aray
loop	lôp
est	ét
das	dá
corn	cỏn
harm	hảm
afford	aford
res	ré
surrounded	surounded
max	mã
mix	mĩ
diffusion	difusion
tons	tón
dans	dán
guns	gún
maps	máp
dad	đa
lessons	lesons
assess	asess
tissues	tisues
themes	thếm
arrive	arive
assignment	asignment
marry	mary
carrier	carier
es	é
bias	bía
marx	mã
ties	tié
russell	rusell
norms	nóm
assured	asured
affecting	afecting
phys	phý
defend	đền
lesser	leser
thee	thê
affair	afair
moore	mổe
sessions	sesions
arrest	arest
associates	asociates
associate	asociate
correctly	corectly
asset	aset
sur	sủ
lots	lót
beer	bể
refuse	reùse
affects	afects
bars	bá
coefficients	coeficients
differentiation	diferentiation
poets	poét
rays	ráy
las	lá
arrested	arested
lens	lén
territories	teritories
differently	diferently
barrier	barier
er	ẻ
harris	haris
ix	ĩ
missed	mised
bits	bít
carries	caries
rats	rát
terror	teror
mississippi	misissippi
corresponds	coresponds
barriers	bariers
moses	moé
boats	boát
dawn	dăn
thereof	thềo
susan	suán
morris	moris
irrigation	irigation
burst	bút
bow	bơ
corruption	coruption
assumes	asumes
guest	guét
territorial	teritorial
rows	rớ
correction	corection
sixteen	ssixteen
buyer	buyẻ
ross	ros
buffer	bufer
tries	trié
affection	afection
missouri	misouri
assault	asault
arrow	arow
surrender	surender
burn	bủn
cuts	cút
correspond	corespond
kiss	kis
missionary	misionary
peer	pể
currents	curents
assisted	asisted
pierre	piere
boss	bos
chiefs	chié
assembled	asembled
dissolved	disolved
assurance	asurance
dense	dến
pays	páy
ussr	usr
assessed	asessed
guys	guý
differs	difers
murray	muray
irregular	iregular
horror	horor
sixteenth	ssixteenth
russians	rusians
horn	hỏn
assertion	asertion
asserted	aserted
quest	quét
assure	asure
meets	mết
arrange	arange
missions	misions
sins	sín
arizona	aiona
assessing	asessing
carriers	cariers
deer	dể
dies	dié
ist	ít
trips	tríp
chaos	cháo
efficacy	eficacy
chairs	chái
cow	cơ
burns	bún
torn	tỏn
dissertation	disertation
corrected	corected
tips	típ
peers	pế
hans	hán
deeds	đế
carriage	cariage
hers	hé
norm	nỏm
vis	ví
tariff	taif
borrowed	borowed
missionaries	misionaries
harrison	harison
correlated	corelated
buffalo	bufalo
narrator	narator
lungs	lúng
tense	tến
norway	nơảy
nest	nét
arriving	ariving
assert	asert
bass	bas
deed	đê
keen	kên
cups	cúp
beef	bề
donor	dổn
sorrow	sorow
noon	nôn
boots	bốt
marriages	mariages
irrelevant	irelevant
laura	lẩu
assign	asign
dissolution	disolution
differing	difering
ar	ả
quasi	quái
kissed	kised
sums	súm
hurry	hury
terrorism	terorism
boom	bôm
dos	dó
cats	cát
narratives	naratives
mama	mâm
mcgraw	mcgră
arrows	arows
ins	ín
charm	chảm
ieee	iee
assignments	asignments
surroundings	suroundings
correlations	corelations
differentiated	diferentiated
ref	rè
auf	àu
buyers	buyé
os	ó
gary	gảy
mess	mes
affinity	afinity
assessments	asessments
efficiently	eficiently
diffuse	difuse
aa	â
straw	stră
sits	sít
hurried	huried
daddy	dady
borrowing	borowing
barry	bary
messenger	mesenger
cows	cớ
larry	lary
gaps	gáp
terrain	terain
ir	ỉ
barrel	barel
lest	lét
mar	mả
affirmative	afirmative
ass	as
doorway	dơảy
missile	misile
effected	efected
garrison	garison
marrow	marow
nuts	nút
corrupt	corupt
mars	má
reorganization	reoganiation
borrow	borow
barn	bản
horrible	horible
terry	tery
corrosion	corosion
afforded	aforded
wednesday	wwednesday
sierra	siera
corridor	coridor
assimilation	asimilation
affective	afective
differed	difered
bis	bí
ser	sẻ
terrorist	terorist
lets	lét
ups	úp
chips	chíp
assay	asay
aus	áu
quartz	quat
curse	cué
differentiate	diferentiate
burma	bủma
corrections	corections
lawn	lăn
chooses	chôés
cox	cõ
nos	nó
asserts	aserts
suffice	sufice
refuses	reùses
assistants	asistants
affirmed	afirmed
morrow	morow
cues	cué
irrational	irational
aux	ãu
arrives	arives
irs	í
bee	bê
terrace	terace
missiles	misiles
poorer	pôẻr
suffrage	sufrage
boot	bôt
diana	diân
lisa	lía
irradiation	iradiation
issuing	isuing
tossed	tosed
maya	mây
toes	toé
var	vả
tops	tóp
moss	mos
loops	lốp
sara	sẩ
suffers	sufers
luis	lúi
hits	hít
diffraction	difraction
quarrel	quarel
mirrors	mirors
owns	ớn
dissolve	disolve
mist	mít
tariffs	taifs
berry	bery
tor	tỏ
cor	cỏ
taxi	tãi
pierce	piểc
terribly	teribly
guru	gủu
irrespective	irespective
tis	tí
assemblies	asemblies
correspondent	corespondent
horns	hón
venezuela	venuela
tens	tén
bees	bế
dissatisfaction	disatisfaction
affiliation	afiliation
terrestrial	terestrial
imf	ìm
cherry	chery
gossip	gosip
harriet	hariet
irritation	iritation
buses	bué
nasa	nấ
rosa	roá
choir	chỏi
affiliated	afiliated
hips	híp
dissent	disent
carroll	caroll
lust	lút
reef	rề
donors	dốn
hats	hát
merry	mery
morrison	morison
ses	sé
gown	gơn
af	à
erroneous	eroneous
coats	coát
guessed	guesed
assassination	asassination
diarrhea	diarhea
thirst	thít
geoffrey	geofrey
affirmation	afirmation
massacre	masacre
surrendered	surendered
diets	diét
messiah	mesiah
dots	dót
hawk	hăk
assisting	asisting
transnational	ttransnational
traps	tráp
dissociation	disociation
sofa	soà
mais	mái
esp	ép
coffin	cofin
arranging	aranging
terrified	terified
caps	cáp
tore	toẻ
asserting	aserting
barren	baren
dissemination	disemination
assemble	asemble
guerrilla	guerilla
thief	thiè
barred	bared
xix	xĩ
goats	goát
affirm	afirm
bury	buỷ
hairs	hái
troop	trôp
myers	myé
nets	nét
assigning	asigning
surround	suround
essex	esex
narrowly	narowly
hoffman	hofman
barracks	baracks
queer	quể
mast	mát
boost	bốt
corrective	corective
barrels	barels
ngos	ngó
cans	cán
arrays	arays
oo	ô
conf	còn
teen	tên
teens	tến
lays	láy
como	côm
honors	hốn
tier	tiẻ
terrorists	terorists
roofs	rố
roar	roả
sans	sán
cas	cá
assertions	asertions
sworn	sưởn
homo	hôm
massage	masage
marrying	marying
eec	êc
tar	tả
mis	mí
narrowed	narowed
assent	asent
afro	ảo
ox	õ
sufferings	suferings
goose	gốe
correlate	corelate
unseen	úunseen
correcting	corecting
narrower	narower
pier	piẻ
barrett	barett
chess	ches
dissatisfied	disatisfied
buys	buý
merrill	merill
dissection	disection
visa	vía
correlates	corelates
irreversible	ireversible
bosom	bốm
cos	có
nuns	nún
casts	cát
essentials	esentials
kissing	kising
currencies	curencies
carr	car
hurricane	huricane
hast	hát
mussolini	musolini
cheer	chể
nests	nét
assoc	asoc
affectionate	afectionate
aura	ẩu
assam	asam
dwarf	dừa
toast	toát
apr	ảp
queens	quến
sufficiency	suficiency
downs	dớn
cops	cóp
gaussian	gausian
affluent	afluent
raja	rậ
dams	dám
afflicted	aflicted
nur	nủ
hist	hít
correctness	corectness
rama	râm
mifflin	miflin
yr	ỷ
arrests	arests
borrower	borower
char	chả
dir	dỉ
gangs	gáng
ere	ể
ax	ã
irresistible	iresistible
issuance	isuance
affords	afords
affections	afections
correspondingly	corespondingly
dues	dué
narration	naration
huts	hút
dissenting	disenting
rust	rút
issuer	isuer
chores	choé
dana	dân
coasts	coát
boast	boát
terrific	terific
toss	tos
arrogant	arogant
narrowing	narowing
mw	mư
doom	dôm
arrogance	arogance
ee	ê
norris	noris
assemblage	asemblage
rex	rẽ
bust	bút
niece	niêc
dyes	dyé
surf	sù
sw	sư
rene	rên
ef	è
terrifying	terifying
nw	nư
sess	ses
morse	moé
hangs	háng
bois	bói
assigns	asigns
horrors	horors
assimilated	asimilated
ness	nes
berries	beries
curricula	curicula
ans	án
kisses	kises
irritated	iritated
dar	dả
dow	dơ
irrigated	irigated
peered	ppeered
vow	vơ
ter	tẻ
roast	roát
nora	noả
herr	her
mas	má
casa	cấ
bows	bớ
www	ww
orissa	oisa
kerr	ker
urn	ủn
aj	ạ
dissipation	disipation
disseminated	diseminated
lessen	lesen
turf	tù
hussein	husein
assays	asays
mir	mỉ
sown	sơn
oj	ọ
assuring	asuring
dee	dê
sussex	susex
differentials	diferentials
charms	chám
vows	vớ
kissinger	kisinger
gujarat	guẩt
effluent	efluent
differentiating	diferentiating
dist	dít
bosses	boses
surrounds	surounds
quarry	quary
oxidized	oidied
boris	bói
terra	tera
irresponsible	iresponsible
laos	láo
corridors	coridors
dessert	desert
raj	rạ
poisson	poison
messengers	mesengers
oats	oát
assurances	asurances
thorn	thỏn
chef	chè
ko	không
garrett	garett
herring	hering
carrie	carie
doris	dói
corresponded	coresponded
oxen	oẽn
ther	thẻ
arrivals	arivals
assertive	asertive
quart	quảt
dissimilar	disimilar
correspondents	corespondents
assembling	asembling
sow	sơ
bats	bát
lor	lỏ
surrogate	surogate
lessee	lesee
assaults	asaults
lois	lói
irradiated	iradiated
loom	lôm
sus	sú
ooo	oo
suffix	sufix
husserl	huserl
gis	gí
associative	asociative
affirming	afirming
cons	cón
nasser	naser
guerrillas	guerillas
irregularities	iregularities
piers	pié
horrified	horified
corrupted	corupted
erratic	eratic
majors	máo
loaf	loà
vest	vét
burr	bur
carrots	carots
lorraine	loraine
terraces	teraces
curry	cury
pius	píu
tow	tơ
dd	đ
quarrels	quarels
reefs	rế
dass	das
vor	vỏ
misses	mises
aw	ă
assortment	asortment
cuff	cuf
ras	rá
lama	lâm
cassette	casette
tee	tê
surrey	surey
muse	mué
hurriedly	huriedly
diffused	difused
afferent	aferent
borrowers	borowers
caffeine	cafeine
carriages	cariages
affordable	afordable
harrington	harington
beset	bết
dissipated	disipated
moor	mổ
ur	ủ
mats	mát
affirms	afirms
affidavit	afidavit
bays	báy
cass	cas
deem	dêm
mirrored	mirored
esse	ese
kw	kư
asa	ấ
suffolk	sufolk
assures	asures
diese	diế
affiliates	afiliates
messianic	mesianic
sorrows	sorows
liar	lỉa
deduce	đêuc
assists	asists
boer	boẻ
hess	hes
correctional	corectional
tossing	tosing
runaway	runăay
barr	bar
affinities	afinities
barrow	barow
boron	bổn
irritating	iritating
mer	mẻ
lessened	lesened
reorganized	reoganied
sachs	sách
cheered	ccheered
gaas	gấ
assimilate	asimilate
dora	doả
dissolving	disolving
monsoon	monon
boon	bôn
moose	mốe
neue	nêu
hirsch	hích
hoffmann	hofmann
carrot	carot
affiliate	afiliate
ber	bẻ
buffers	bufers
een	ên
laissez	laisez
mono	môn
trafficking	traficking
efficiencies	eficiencies
cheers	chế
sas	sá
torso	tố
trays	tráy
taxa	tẫ
cw	cư
torres	tores
mus	mú
dodd	dod
assemblages	asemblages
bas	bá
guts	gút
guessing	guesing
aussi	ausi
asp	áp
kerry	kery
surfactant	ssurfactant
gus	gú
muffled	mufled
nero	nẻo
nee	nê
tara	tẩ
hurrying	hurying
inf	ìn
dissonance	disonance
verso	véo
affliction	afliction
aaa	aa
eros	éo
affiliations	afiliations
thorax	thoã
chaps	cháp
moran	moản
muir	mủi
hassan	hasan
looms	lốm
dieser	diể
effecting	efecting
moors	mố
ver	vẻ
irritable	iritable
curricular	curicular
loosen	lôén
beech	bêch
marries	maries
hawks	hắk
dyed	đye
bose	boé
afar	ẩ
arresting	aresting
outlaw	outlă
dissenters	disenters
arrhythmias	arhythmias
irritability	iritability
mos	mó
beet	bêt
norepinephrine	nnorepinephrine
theorizing	theoiing
raf	rà
oasis	oái
sis	sí
rossi	rosi
dyer	dyẻ
barrage	barage
assorted	asorted
thorns	thón
bern	bẻn
narrated	narated
russo	ruso
lessor	lesor
affluence	afluence
yer	yẻ
associating	asociating
uss	us
ddt	đt
burrows	burows
hens	hén
boxer	boẻ
assassinated	asassinated
tres	tré
err	er
buff	buf
dissolves	disolves
paw	pă
irregularly	iregularly
hasan	hấn
cary	cảy
arrears	arears
lax	lã
lex	lẽ
hays	háy
dormitory	ddormitory
defends	đến
taps	táp
hiss	his
assyrian	asyrian
baffled	bafled
boar	boả
kits	kít
erroneously	eroneously
torrent	torent
effusion	efusion
def	dè
hermes	hếm
assaulted	asaulted
bessie	besie
hertz	het
chests	chét
tess	tes
lawns	lắn
beers	bế
diss	dis
pies	pié
messy	mesy
vers	vé
terre	tere
rees	rế
har	hả
lis	lí
veneer	vener
ems	ém
barring	baring
guerre	guere
nana	nân
assuredly	asuredly
sar	sả
hier	hiẻ
irreducible	ireducible
trojan	troạn
corrosive	corosive
irregularity	iregularity
rw	rư
canaan	canan
gasp	gáp
boasts	boát
hissed	hised
trois	trói
bur	bủ
voor	vổ
gauss	gaus
haas	hấ
barns	bán
affectionately	afectionately
horrid	horid
thaw	thă
airs	ái
dissected	disected
tiers	tié
gums	gúm
nassau	nasau
ars	á
kern	kẻn
burroughs	buroughs
seer	sể
dod	đo
museo	muéo
bess	bes
berne	bển
mes	mé
gays	gáy
musee	muế
ej	ẹ
sono	sôn
irrevocable	irevocable
bets	bét
massey	masey
efficacious	eficacious
jw	jư
dw	dư
errand	erand
buren	buẻn
horowitz	hơit
chow	chơ
xerox	xẽo
dissociated	disociated
quran	quản
hesse	hese
noir	nỏi
masse	mase
uns	ún
hues	hué
hoop	hôp
gowns	gớn
guesses	gueses
cora	coả
duffy	dufy
assassin	asassin
vas	vá
liszt	lit
suffices	sufices
diarrhoea	diarhoea
buffet	bufet
deems	dếm
curzon	cuon
ww	wư
unrecognized	unecognied
yrs	ý
misc	míc
oars	oá
borrowings	borowings
soot	sôt
dost	dót
sufi	sùi
sufferers	suferers
ism	ím
sox	sõ
iff	if
tris	trí
dura	dủa
huron	huỏn
cassie	casie
terrors	terors
affixed	afixed
rowan	rơan
harms	hám
ers	é
barrio	bario
assailed	asailed
effector	efector
visas	vía
russ	rus
mara	mẩ
nas	ná
chassis	chasis
oxidizing	oidiing
turret	turet
serfs	sé
duff	duf
moons	mốn
muses	mué
dix	dĩ
refs	ré
marred	mared
affording	afording
bor	bỏ
corroborated	coroborated
disseminate	diseminate
bosch	bóch
burrow	burow
corrugated	corugated
chasm	chám
voir	vỏi
mori	mỏi
assn	asn
tex	tẽ
lessening	lesening
barron	baron
efferent	eferent
hiram	hiảm
lessing	lesing
truss	trus
irreconcilable	ireconcilable
vos	vó
sens	sén
cherries	cheries
norse	noé
dissension	disension
bins	bín
arafat	ầarafat
assesses	asesses
cowan	cơan
rossetti	rosetti
corral	coral
venezuelan	venuelan
chauffeur	chaufeur
hee	hê
carmichael	ccarmichael
differentiates	diferentiates
vn	Việt Nam
gifford	giford
soar	soả
gist	gít
correspondences	corespondences
erred	ered
boers	boé
tiffany	tifany
horribly	horibly
cassava	casava
issn	isn
liens	lién
ics	íc
orr	or
assertiveness	asertiveness
ij	ị
boas	boá
meme	mêm
guerra	guera
hurst	hút
buffered	bufered
narrows	narows
taxis	tái
massacres	masacres
sensitized	senitied
triassic	triasic
essences	esences
rosary	roảy
correlative	corelative
suffixes	sufixes
hurricanes	huricanes
docs	dóc
sensitization	senitiation
kessler	kesler
hops	hóp
messaging	mesaging
tierra	tiera
dips	díp
dwarfs	dứa
harriman	hariman
arrayed	arayed
pow	pơ
surrendering	surendering
loo	lô
casas	cấ
ecr	ẻc
lorry	lory
masts	mát
loot	lôt
mists	mít
durand	đuản
heme	hêm
uf	ù
pharm	phảm
ara	ẩ
eps	ép
hari	hải
ganga	gâng
masson	mason
curr	cur
desserts	deserts
reorganize	reoganie
cassandra	casandra
tins	tín
sorrowful	sorowful
oar	oả
quark	quảk
ons	ón
boo	bô
doorways	dơáy
bene	bên
charred	chared
laparoscopic	llaparoscopic
pw	pư
moot	môt
garrisons	garisons
pawn	păn
acs	ác
sufferer	suferer
differentially	diferentially
dada	đâ
dissertations	disertations
emf	èm
rams	rám
sys	sý
cassidy	casidy
arranges	aranges
denser	dển
barre	bare
dissipate	disipate
irrevocably	irevocably
chore	choẻ
massed	mased
lori	lỏi
causa	cấu
ow	ơ
uprooted	ủuprooted
mora	moả
mari	mải
ops	óp
rims	rím
truer	truẻ
musa	múa
affaires	afaires
rana	rân
chops	chóp
homozygous	homygous
suis	súi
renee	rene
effectual	efectual
borrows	borows
surrealism	surealism
usc	úc
hissing	hising
baja	bậ
isp	íp
soaps	soáp
gust	gút
vassal	vasal
lara	lẩ
longs	lóng
hoof	hồ
goffman	gofman
mens	mén
barrister	barister
torr	tor
cuffs	cufs
irreparable	ireparable
ture	tuẻ
quarries	quaries
saffron	safron
gw	gư
lass	las
beets	bết
effectually	efectually
herzog	heog
assyria	asyria
oas	oá
norwood	noỏd
buffering	bufering
duress	dues
lars	lá
ams	ám
affront	afront
casserole	caserole
mussels	musels
carrington	carington
cusp	cúp
hausa	hấu
hosp	hóp
surfactants	ssurfactants
leech	lêch
mor	mỏ
assignee	asignee
garrick	garick
theseus	thếu
vans	ván
lees	lế
oro	ổ
ari	ải
nara	nẩ
oss	os
osi	ói
mira	mỉa
cossacks	cosacks
merritt	meritt
vassals	vasals
mirroring	miroring
errands	erands
irrationality	irationality
surrealist	surealist
pee	pê
busch	búch
horst	hót
saussure	sausure
ruse	rué
mays	máy
irritant	iritant
trieste	triết
ruffled	rufled
thor	thỏ
ies	ié
assassins	asassins
gar	gả
mans	mán
ess	es
currie	curie
suns	sún
trier	triẻ
diffusing	difusing
tw	tư
coop	côp
vere	vể
bradycardia	bbradycardia
assessor	asessor
exxon	exon
harrisburg	harisburg
lisp	líp
ifn	ìn
bw	bư
serra	sera
horrific	horific
torre	tore
aix	ãi
assembler	asembler
mirza	mia
curran	curan
hereof	hềo
saws	sắ
essai	esai
derrick	derick
afflictions	aflictions
uri	ủi
dif	dì
harrow	harow
caro	cảo
disseminating	diseminating
lamar	lẩm
assayed	asayed
errant	erant
darmstadt	ddarmstadt
bari	bải
dude	đue
dirac	diảc
cassius	casius
chakra	chảka
herrera	herera
dissecting	disecting
curfew	cừe
dormitories	ddormitories
sacs	sác
cassettes	casettes
cara	cẩ
vero	vẻo
asses	ases
assented	asented
ajax	ẫ
cocoon	cocon
bassett	basett
sufficed	suficed
affidavits	afidavits
affirmations	afirmations
horrifying	horifying
bono	bôn
handmade	hhandmade
ips	íp
harrowing	harowing
booze	boe
dissociate	disociate
geoff	geof
dieses	diế
effigy	efigy
corrupting	corupting
esr	ẻ
ree	rê
caso	cáo
ossification	osification
issuers	isuers
taos	táo
corrects	corects
massacred	masacred
diffusivity	difusivity
tes	té
dorm	dỏm
esc	éc
suarez	suae
baffling	bafling
laps	láp
rasa	rấ
hasta	hất
tern	tẻn
moser	moẻ
effet	efet
assessors	asessors
atwood	ăatwood
terse	tế
effortlessly	efortlessly
dissociative	disociative
reps	rép
syst	sýt
guerrero	guerero
terracotta	teracotta
mosses	moses
barrie	barie
loess	loes
marriott	mariott
morn	mỏn
surat	suảt
lux	lũ
massif	masif
vir	vỉ
cassell	casell
merriam	meriam
barricades	baricades
mons	món
lacrimal	llacrimal
sax	sã
ias	ía
ros	ró
trajan	trận
coo	cô
neuen	nêun
didst	đít
cur	củ
chiapas	chiấp
chefs	ché
coon	côn
merrily	merily
dossier	dosier
seers	sế
massively	masively
bos	bó
chaff	chaf
sos	só
terrier	terier
nis	ní
moro	mổ
arrhythmia	arhythmia
tarn	tản
samaj	sậm
assailant	asailant
irresponsibility	iresponsibility
ast	át
narrowness	narowness
loco	lôc
herrick	herick
lans	lán
rus	rú
monsignor	mmonsignor
dens	dén
hn	Hà Nội
bir	bỉ
garry	gary
correlating	corelating
herzl	hel
mana	mân
truest	truét
booms	bốm
bans	bán
corroborate	coroborate
torrents	torents
somoza	soma
diesem	diếm
coffins	cofins
narrators	narators
barrington	barington
bursa	búa
roost	rốt
cossack	cosack
hoax	hoã
assiduously	asiduously
mins	mín
effluents	efluents
corroboration	coroboration
terraced	teraced
lows	lớ
theorized	theoied
buffaloes	bufaloes
aps	áp
epr	ẻp
nurs	nú
quartzite	quatite
arroyo	aroyo
surreptitiously	sureptitiously
choirs	chói
hangar	hẩng
hoops	hốp
osmosis	ómosis
noose	nốe
gif	gì
mee	mê
huff	huf
suffocating	sufocating
assimilating	asimilating
irritate	iritate
garret	garet
sari	sải
beseech	beéch
affectation	afectation
merriment	meriment
hors	hó
haw	hă
nox	nõ
lys	lý
ifs	í
moritz	moit
arrowheads	arowheads
uaw	uă
arrowhead	arowhead
assisi	asisi
effeminate	efeminate
hoofs	hố
mow	mơ
barrios	barios
lassen	lasen
essen	esen
asi	ái
dais	dái
tarsus	táu
tas	tá
barrows	barows
asshole	ashole
irrelevance	irelevance
hussain	husain
taro	tảo
afferents	aferents
sor	sỏ
ys	ý
fw	fư
carryover	caryover
doer	doẻ
ims	ím
desde	đế
hara	hẩ
nissan	nisan
lair	lải
cosa	coá
gaap	gâp
effusions	efusions
unseemly	úunseemly
coffers	cofers
muffins	mufins
ets	ét
vw	vư
bums	búm
horrendous	horendous
anwar	ănar
lar	lả
affix	afix
suffused	sufused
lorries	lories
essayist	esayist
looser	lôér
tongs	tóng
liars	lía
rossini	rosini
burrowing	burowing
arya	ẩy
bangs	báng
verne	vển
veered	vveered
darrow	darow
irma	ỉma
nieces	niếc
monopolized	monpolied
hw	hư
homogenization	homgeniation
messina	mesina
quirk	quỉk
turrets	turets
coax	coã
efflux	eflux
aas	ấ
asm	ám
usaf	ùa
resp	rép
terri	teri
ens	én
herrmann	hermann
carranza	caranza
russel	rusel
tics	tíc
iss	is
moms	móm
lynx	lỹn
derry	dery
choctaw	choctă
soo	sô
osseous	oseous
dias	día
eos	éo
irrepressible	irepressible
dore	doẻ
busts	bút
monopolize	monpolie
deren	dển
irresistibly	iresistibly
thessalonians	thesalonians
dwyer	dưyẻ
hos	hó
serf	sè
ecj	ẹc
darn	dản
meer	mể
missy	misy
vests	vét
tessa	tesa
aan	ân
surreal	sureal
ajar	ẩ
ary	ảy
transmutation	ttransmutation
reexamination	rreexamination
coco	côc
thorac	thoảc
reorganizing	reoganiing
dido	đio
heen	hên
effortless	efortless
marr	mar
lana	lân
dissimilarity	disimilarity
mies	mié
correlational	corelational
barricade	baricade
narrowest	narowest
hirst	hít
doran	doản
urns	ún
trusses	truses
carrion	carion
messing	mesing
darrell	darell
diffuses	difuses
loon	lôn
messed	mesed
essentialist	esentialist
irradiance	iradiance
eff	ef
choses	choé
lusaka	luáka
huns	hún
linseed	llinseed
serrano	serano
lw	lư
assyrians	asyrians
voss	vos
assassinate	asassinate
moans	moán
surrenders	surenders
mussel	musel
oozing	oing
hoff	hof
canaanite	cananite
peshawar	peshăar
torrance	torance
tasso	taso
massa	masa
tamar	tẩm
sows	sớ
cher	chẻ
inlaw	inlă
gama	gâm
rojas	roá
dissented	disented
essentialism	esentialism
harried	haried
loro	lổ
ese	ế
affirmatively	afirmatively
assassinations	asassinations
baffle	bafle
muffin	mufin
narrate	narate
hoo	hô
corr	cor
kee	kê
narrating	narating
torrey	torey
congr	cỏng
associational	asociational
irr	ir
rostow	rớt
assailants	asailants
corso	cố
gusts	gút
lysozyme	lyoyme
dissect	disect
diff	dif
hassle	hasle
dade	đae
hamas	hấm
toro	tổ
suisse	suise
terrell	terell
quits	quít
nots	nót
boxers	boé
tosses	toses
noaa	noâ
afm	àm
maj	mạ
taj	tạ
cusps	cúp
misra	mỉa
irreverent	ireverent
didn	đin
ost	ót
sissy	sisy
poco	pôc
quarrelled	quarelled
merrick	merick
tiene	tiên
lessens	lesens
arf	à
nes	né
moffat	mofat
essere	esere
nair	nải
nussbaum	nusbaum
mossy	mosy
messrs	mesrs
dor	dỏ
narrates	narates
ucs	úc
giraffe	giafe
affable	afable
hessian	hesian
thierry	thiery
diesen	diến
haji	hại
reengineering	rreengineering
doo	dô
basu	báu
squaw	squă
barrack	barack
assuage	asuage
asst	ast
ker	kẻ
tori	tỏi
mots	mót
territoriality	teritoriality
bier	biẻ
trojans	troán
duran	duản
mississippian	misissippian
irreplaceable	ireplaceable
lias	lía
tur	tủ
ner	nẻ
rajya	rậy
tarry	tary
necrotizing	necotiing
irrefutable	irefutable
afr	ả
dorado	đoảo
veer	vể
puis	púi
uj	ụ
laparoscopy	llaparoscopy
dorn	dỏn
gasps	gáp
runaways	runăays
homogenized	homgenied
arrhenius	arhenius
moo	mô
haus	háu
raffles	rafles
poussin	pousin
moray	moảy
exe	ễ
tuff	tuf
ust	út
ghee	ghê
chas	chá
ruff	ruf
cassirer	casirer
churn	chủn
lusts	lút
ius	íu
mair	mải
aia	âi
irrigate	irigate
vasquez	vaque
caa	câ
quarrying	quarying
mex	mẽ
icj	ịc
sars	sá
dissonant	disonant
woodbridge	wwoodbridge
carotenoids	ccarotenoids
hus	hú
surrogates	surogates
meso	méo
venezia	venia
maw	mă
thar	thả
afflict	aflict
mujer	muẻ
sorrel	sorel
nyerere	nyểe
terns	tén
arras	aras
correspondance	corespondance
nasir	nải
buns	bún
quarreling	quareling
buffy	bufy
rungs	rúng
lif	lì
tues	tué
soes	soé
husayn	huáyn
roars	roá
roms	róm
bakr	bảk
goff	gof
saar	sẩ
corrigan	corigan
iaa	iâ
liss	lis
tits	tít
puja	pụa
erring	ering
nics	níc
sura	sủa
ipsa	ípa
sofas	soá
xerxes	xế
varna	vẩn
maris	mái
mets	mét
messer	meser
ooze	oe
sawn	săn
sujet	suẹt
usp	úp
assaulting	asaulting
nama	nâm
dur	dủ
chir	chỉ
quarrelling	quarelling
diffracted	difracted
vox	võ
diffusive	difusive
basra	bẩ
serrated	serated
dodds	dods
asch	ách
lamas	lấm
affd	afd
sessile	sesile
usr	ủ
bessel	besel
barak	bẩk
affine	afine
cots	cót
guesswork	gueswork
dons	dón
oversaw	oversă
mesure	meúre
assistive	asistive
suffocation	sufocation
reorganizations	reoganiations
buss	bus
vassar	vasar
hurrah	hurah
asc	ác
nar	nả
bora	boả
hajj	haj
gossiping	gosiping
toms	tóm
irritants	iritants
vaux	vãu
erst	ét
mayr	mảy
irreversibly	ireversibly
chee	chê
esso	eso
terme	tểm
yee	yê
lira	lỉa
theorize	theoie
gans	gán
dissensions	disensions
hora	hoả
corroded	coroded
hoary	hoảy
naa	nâ
cassel	casel
benes	bến
masai	mấi
dissolute	disolute
roos	rố
darren	daren
basso	baso
byers	byé
hams	hám
borax	boã
assiduous	asiduous
dusts	dút
loos	lố
thais	thái
vats	vát
difficile	dificile
mawr	mẳ
oxidize	oidie
ais	ái
herz	he
chats	chát
hor	hỏ
morass	moas
quarreled	quareled
toasts	toát
dodson	đốn
ocr	ỏc
effaced	efaced
sama	sâm
aswan	ấn
sams	sám
misdirected	mmisdirected
vax	vã
theor	thẻo
aff	af
quarrelsome	quarelsome
eso	éo
laszlo	lalo
defuse	deùse
doers	doé
affixes	afixes
sufis	súi
cura	của
mois	mói
transfected	ttransfected
lasso	laso
gaya	gây
uw	ư
iww	iw
darryl	daryl
maru	mảu
assez	asez
unrecognizable	unecogniable
ris	rí
maas	mấ
goss	gos
vee	vê
naw	nă
hoot	hôt
hoar	hoả
bissau	bisau
huffman	hufman
assamese	asamese
ves	vé
effie	efie
eretz	êt
uar	ủa
diffuser	difuser
larsson	lason
morrill	morill
afforestation	aforestation
poop	pôp
goo	gô
ruts	rút
torrential	torential
vasa	vấ
garza	gâ
coffey	cofey
herzberg	heberg
buffon	bufon
dissipative	disipative
massing	masing
duns	dún
ors	ó
arr	ar
sips	síp
dara	dẩ
massaging	masaging
barristers	baristers
thess	thes
ler	lẻ
terrorized	terorized
tyrrell	tyrell
sussman	susman
visser	viser
assembles	asembles
tana	tân
cosmo	cốm
hoes	hoé
aro	ảo
monogr	mổng
maura	mẩu
rensselaer	renselaer
sirs	sí
tos	tó
ats	át
cwt	cưt
thos	thó
effacing	efacing
erm	ẻm
neff	nef
bassoon	basoon
tof	tò
tees	tế
rosas	roá
muss	mus
marais	mấi
essais	esais
massaged	masaged
suffocated	sufocated
differentiations	diferentiations
gosse	gose
stanislaw	stanislă
ipr	ỉp
sues	sué
assignable	asignable
surrealists	surealists
hir	hỉ
leer	lể
unfeeling	ùunfeeling
usn	ún
tyr	tỷ
cams	cám
disservice	diservice
tresses	treses
beret	bểt
orsay	oáy
mof	mò
sassoon	sasoon
mauss	maus
misspelled	mispelled
maasai	mmaasai
amr	ảm
hana	hân
russet	ruset
irritably	iritably
baa	bâ
saa	sâ
mossbauer	mosbauer
murat	muảt
currant	curant
aram	ẩm
irreversibility	ireversibility
corruptions	coruptions
ries	rié
dessen	desen
missus	misus
bij	bị
coarctation	ccoarctation
gur	gủ
ospf	òp
baffles	bafles
rer	rẻ
mujeres	muế
trams	trám
uprooting	ủuprooting
ocs	óc
varus	váu
barrymore	barymore
ori	ỏi
dari	dải
irretrievably	iretrievably
dawns	dắn
varma	vẩm
ruffians	rufians
missoula	misoula
morrell	morell
thieme	thiêm
bask	bák
neues	nếu
aiaa	aia
nir	nỉ
tassels	tasels
hof	hò
dads	đá
essenes	esenes
murry	mury
breakaway	breakăay
harrod	harod
murrow	murow
durst	dút
manas	mấn
tors	tó
vara	vẩ
lasswell	laswell
naps	náp
cocoons	cocons
monochromator	mmonochromator
quests	quét
ipx	ĩp
dowd	đơ
straightaway	sstraightaway
bessemer	besemer
surreptitious	sureptitious
hussars	husars
thessaly	thesaly
roo	rô
hur	hủ
affaire	afaire
hons	hón
souffle	soufle
vern	vẻn
misshapen	mishapen
voix	või
cana	cân
eof	èo
norsk	nók
basses	bases
assail	asail
ajr	ả
barrenness	barenness
traffickers	trafickers
effigies	efigies
arraignment	araignment
hussey	husey
secs	séc
tass	tas
sais	sái
isps	íp
charan	chẩn
naca	nâc
dijk	dịk
tarragon	taragon
lors	ló
buffeted	bufeted
irrigating	irigating
quasars	quấ
errol	erol
effectors	efectors
nist	nít
burrell	burell
tassel	tasel
nuer	nuẻ
muerte	muểt
goers	goé
corregidor	coregidor
assizes	asizes
rossiter	rositer
merriman	meriman
carrillo	carillo
sadducees	ssadducees
assize	asize
bast	bát
banff	banf
vaca	vâc
lessees	lesees
poore	pổe
bossy	bosy
quis	quí
bedridden	bedriden
chins	chín
marat	mẩt
myrrh	myrh
bajo	bạo
chakras	chảkas
iw	iư
suffragists	sufragists
varro	varo
pues	pué
phasor	phảo
bara	bẩ
tiff	tif
nonsmokers	nnonsmokers
gissing	gising
lassitude	lasitude
garrisoned	garisoned
dde	đe
gooch	gôch
asr	ả
pierces	piếc
carruthers	caruthers
tus	tú
wednesdays	wwednesdays
surfers	sué
sensitizing	senitiing
currants	curants
diffusely	difusely
termes	tếm
horwitz	hơit
doren	doẻn
soars	soá
morrissey	morissey
thurs	thú
ques	qué
dissimulation	disimulation
thiers	thié
nasr	nả
ecs	éc
chickasaw	chickasă
vari	vải
itr	ỉt
atr	ảt
dado	đao
irreligious	ireligious
susa	súa
transsexual	transexual
massimo	masimo
canaanites	cananites
riff	rif
terrence	terence
isr	ỉ
carrera	carera
maa	mâ
paa	pâ
marriageable	mariageable
ier	iẻ
uproot	ủuproot
surfer	suẻ
quarried	quaried
deuce	dêuc
gats	gát
dissipating	disipating
chirac	chiảc
kinshasa	kínhasa
dessus	desus
rips	ríp
narragansett	naragansett
cose	coé
rossii	rosii
meerut	mêủt
risc	ríc
effusive	efusive
monro	mổn
rickshaw	rickshă
nowak	nơak
kirsch	kích
harrell	harell
marys	máy
kershaw	kershă
saps	sáp
neuer	nểu
effectuate	efectuate
saf	sà
howitzers	hoiters
yerkes	yẻkes
taussig	tausig
effacement	efacement
terrains	terains
erratically	eratically
macs	mác
mur	mủ
messes	meses
moos	mố
bierce	biểc
assignor	asignor
thessaloniki	thesaloniki
icr	ỉc
rosso	roso
moron	mổn
hurries	huries
hoffa	hofa
baur	bảu
dodo	đô
hes	hé
vier	viẻ
echr	ẻch
darfur	dảu
duets	duét
pierrot	pierot
carre	care
boars	boá
tarred	tared
hassles	hasles
duffel	dufel
manga	mâng
enfeebled	èneebled
basse	base
differentiable	diferentiable
dissections	disections
barra	bara
cassino	casino
assessable	asessable
sawtooth	ssawtooth
cassia	casia
hurwitz	hưit
poo	pô
hafiz	hai
corrupts	corupts
heer	hể
irritations	iritations
dissenter	disenter
bax	bã
raya	rây
buffs	bufs
haya	hây
durrell	durell
nissen	nisen
isms	ím
corroborating	coroborating
aac	âc
arranger	aranger
cosas	coá
dorr	dor
ruffles	rufles
terrify	terify
baffin	bafin
corroborates	coroborates
buffett	bufett
affordability	afordability
russe	ruse
assemblers	asemblers
thongs	thóng
nomos	nốm
torrid	torid
afflicting	aflicting
missal	misal
choo	chô
arrogantly	arogantly
kyrgyzstan	kygystan
kiefer	kiể
bissell	bisell
hoss	hos
gass	gas
casi	cái
efface	eface
haar	hẩ
berryman	beryman
mayas	mấy
hofer	hoẻ
marissa	maisa
monopolization	monpoliation
assad	asad
vajra	vẩ
mose	moé
nuffield	nufield
mesures	meúres
luxor	luỏ
boson	bốn
myer	myẻ
morristown	moristown
nies	nié
dissipates	disipates
correa	corea
oops	ốp
dorsi	dói
raju	rạu
herrings	herings
nix	nĩ
sosa	soá
ux	ũ
cwa	cưa
dissimilarities	disimilarities
kira	kỉa
muffler	mufler
rasp	ráp
bes	bé
dex	dẽ
messianism	mesianism
daw	dă
assistantships	asistantships
tures	tué
mura	mủa
bulawayo	bulăayo
longo	lông
barro	baro
moffett	mofett
dere	dể
maldonado	mmaldonado
tomo	tôm
ecf	èc
naar	nẩ
uffizi	ufizi
ruffian	rufian
oozed	oed
aran	ẩn
arraigned	araigned
dissociates	disociates
ossian	osian
thana	thân
ruffle	rufle
lossless	losless
monozygotic	monygotic
iee	iê
dorms	dóm
gossips	gosips
assimilates	asimilates
rafferty	raferty
baca	bâc
puissance	puisance
irregulars	iregulars
vex	vẽ
ddc	đc
raff	raf
irrationally	irationally
neem	nêm
tir	tỉ
basset	baset
urs	ú
hoffer	hofer
coxe	coẽ
ters	té
monseigneur	mmonseigneur
soir	sỏi
lassie	lasie
tama	tâm
lacs	lác
herron	heron
asf	à
engrs	éng
lix	lĩ
quays	quáy
misstatement	mistatement
kips	kíp
affronted	afronted
nary	nảy
chessboard	chesboard
sira	sỉa
biff	bif
tener	tển
howitzer	hoiter
barreled	bareled
nuri	nủi
cuffed	cufed
garrulous	garulous
derm	dẻm
ufa	ùa
rajan	rận
barricaded	baricaded
afflicts	aflicts
dene	dên
territorially	teritorially
hertzog	hetog
saran	sẩn
haan	hân
xor	xỏ
effete	efete
luxe	luẽ
naissance	naisance
soong	sông
corrie	corie
duras	dúa
chiffon	chifon
aos	áo
lasch	lách
missa	misa
gossamer	gosamer
dwt	dưt
vets	vét
sierras	sieras
masa	mấ
unsweetened	ứunsweetened
bef	bè
nast	nát
tamas	tấm
asn	án
isc	íc
atf	àt
missive	misive
assessee	asessee
coram	coảm
transdermal	ttransdermal
bosco	bốc
nonrecognition	nnonrecognition
assimilationist	asimilationist
masseter	maseter
rif	rì
viene	viên
choix	chõi
caisson	caison
surrogacy	surogacy
inr	ỉn
dosed	đose
mossad	mosad
gnaw	gnă
barros	baros
rots	rót
carat	cẩt
tojo	tộ
aarp	ẩp
giri	giỉ
taffy	tafy
menger	mểng
sensitize	senitie
corns	cón
bers	bé
pseudocode	ppseudocode
durer	duẻ
truffles	trufles
carotenoid	ccarotenoid
sana	sân
bessarabia	besarabia
sarai	sẩi
aris	ái
gongs	góng
effets	efets
corrector	corector
aja	ậ
tans	tán
baran	bẩn
becher	bểch
ietf	ièt
aaf	ầ
haj	hạ
mips	míp
gos	gó
manx	mãn
redraw	redră
hurons	huón
kessel	kesel
sufferance	suferance
chiasm	chiám
nyssa	nysa
bossuet	bosuet
toot	tôt
biotransformation	bbiotransformation
berets	bết
sessional	sesional
mosse	mose
transcutaneous	ttranscutaneous
yf	ỳ
dds	đs
cassio	casio
casson	cason
ees	ế
monsoons	monons
sass	sas
oxon	ỗn
esser	eser
cus	cú
thessalonica	thesalonica
gassed	gased
irreverence	ireverence
truro	truỏ
sof	sò
suffocate	sufocate
lora	loả
asw	ắ
burrowed	burowed
veneers	veners
effrontery	efrontery
transsexuals	transexuals
ror	rỏ
oop	ôp
dossiers	dosiers
gorse	goé
darya	dẩy
burro	buro
buffoon	bufoon
arran	aran
darauf	dầu
saarc	sẩc
ern	ẻn
oeec	oêc
cassation	casation
orm	ỏm
oooo	oô
ossified	osified
maxi	mãi
messner	mesner
sorrowfully	sorowfully
tirpitz	tipit
misperception	mmisperception
tarrant	tarant
daro	dảo
sternocleidomastoid	ssternocleidomastoid
noor	nổ
ruffin	rufin
memes	mếm
gow	gơ
esset	eset
cutaway	cutăay
eez	e
kisan	kián
ded	đe
hass	has
torrens	torens
merrimack	merimack
currier	curier
khasi	khái
orf	ò
raps	ráp
garrard	garard
gora	goả
naf	nà
saks	sák
deseret	ddeseret
corsair	coải
diffusional	difusional
dda	đa
acr	ảc
aar	ẩ
corroborative	coroborative
mongoose	mongose
woodside	wwoodside
nonrecourse	nnonrecourse
irretrievable	iretrievable
vies	vié
cuss	cus
lassiter	lasiter
ucr	ủc
truffaut	trufaut
safflower	saflower
trims	trím
kharif	khài
assuaged	asuaged
seesaw	sếă
nasi	nái
coons	cốn
quire	quiẻ
harrier	harier
buf	bù
gurr	gur
effendi	efendi
gaff	gaf
hideaway	hideăay
misperceptions	mmisperceptions
icf	ìc
dof	dò
hansson	hanson
busses	buses
queste	quết
maf	mà
taffeta	tafeta
toffler	tofler
urry	ury
tussle	tusle
gassendi	gasendi
quern	quẻn
issei	isei
cassini	casini
curried	curied
muffle	mufle
ararat	ẩararat
ots	ót
seme	sêm
samar	sẩm
narrowband	narowband
giveaway	giveăay
capsized	capied
ayr	ảy
ojo	ộ
issa	isa
coffeehouse	cofeehouse
coffees	cofees
giessen	giesen
taa	tâ
sejm	sẹm
carrick	carick
sorrowing	sorowing
rosser	roser
saris	sái
sisson	sison
taux	tãu
exo	ẽo
surrealistic	surealistic
demodulator	đdemodulator
tanf	tàn
yj	ỵ
sassafras	sasafras
irritates	iritates
dufferin	duferin
acf	àc
essa	esa
herriot	heriot
territoire	teritoire
terr	ter
trist	trít
misstatements	mistatements
ossicles	osicles
dasa	dấ
aur	ảu
terriers	teriers
sapwood	ssapwood
terracing	teracing
merrell	merell
aap	âp
terrorize	terorize
sassy	sasy
hodgepodge	hhodgepodge
hisses	hises
mesmer	mểm
mops	móp
lassalle	lasalle
tars	tá
moffatt	mofatt
byes	byé
dissents	disents
sarma	sẩm
giraffes	giafes
herculaneum	hherculaneum
goran	goản
affectivity	afectivity
quos	quó
pyrrhus	pyrhus
chaffee	chafee
barrens	barens
basf	bà
nys	ný
dyers	dyé
terrigenous	terigenous
mejor	mẻo
tary	tảy
aso	áo
corrals	corals
ruf	rù
errata	erata
errs	ers
morarji	moại
moffitt	mofitt
engr	ẻng
doon	dôn
tryst	trýt
onr	ỏn
lissa	lisa
rasch	rách
kyrgyz	kygy
busse	buse
tuffs	tufs
musset	muset
effeminacy	efeminacy
irremediable	iremediable
coir	cỏi
nayar	nẩy
cosi	cói
hwa	hưa
homozygotes	homygotes
massie	masie
cust	cút
eeo	êo
nonresponse	nnonresponse
hotspot	hhotspot
ddd	dd
daf	dà
serratus	seratus
dissociating	disociating
oris	ói
ifr	ỉ
haa	hâ
nusselt	nuselt
ura	ủa
burrs	burs
quasar	quẩ
carrel	carel
ddl	đl
lossy	losy
marzo	mao
diener	diển
derivatization	deivatiation
arrian	arian
irreparably	ireparably
hori	hỏi
soaks	soák
messier	mesier
irresolute	iresolute
dud	đu
assignation	asignation
moores	môẻs
mown	mơn
nef	nè
cassock	casock
bussy	busy
afs	á
chums	chúm
rois	rói
uwe	ưe
veen	vên
corrode	corode
pwm	pưm
assur	asur
biens	bién
monopolizing	monpoliing
leff	lef
herrnstein	hernstein
sary	sảy
barrera	barera
dowson	dốn
noirs	nói
isn	ín
coser	coẻ
chasms	chám
lef	lè
lus	lú
tarr	tar
shevardnadze	sshevardnadze
boor	bổ
misma	míma
currey	curey
corot	cổt
essayed	esayed
doj	dọ
ojos	ố
henshaw	hénhă
eee	ee
trousseau	trouseau
kesselring	keselring
dede	đê
homogenizing	homgeniing
harrigan	harigan
escher	ểch
affinal	afinal
deen	dên
caf	cà
apj	ạp
orrin	orin
nawaz	na
coomaraswamy	cômaraswamy
differentia	diferentia
marya	mẩy
bylaw	bylă
barroom	baroom
bysshe	byshe
ooooo	ooo
bongo	bông
haram	hẩm
noo	nô
muff	muf
corsairs	coái
herrn	hern
astr	ảt
tora	toả
hama	hâm
tiffin	tifin
roxas	roá
goon	gôn
messieurs	mesieurs
carrara	carara
aat	ât
veces	vếc
readymade	rreadymade
iaf	ìa
hefner	hển
arif	ài
aaas	aas
noms	nóm
peet	pêt
cassatt	casatt
hopf	hòp
aircrew	aỉcew
naxos	náo
terrane	terane
laidlaw	laidlă
pwa	pưa
thins	thín
dudes	đué
essie	esie
efflorescence	eflorescence
thes	thé
coors	cố
haussmann	hausmann
hox	hõ
bufo	buò
hotspots	hhotspots
dama	dâm
senge	sêng
horwood	hoỏd
dissatisfactions	disatisfactions
corruptible	coruptible
massages	masages
murata	muẩt
dinwiddie	dinwidie
kees	kế
morro	moro
taf	tà
lief	liè
gasset	gaset
trow	trơ
trafficked	traficked
haps	háp
renshaw	rénhă
terrorizing	terorizing
loams	loám
nore	noẻ
curriculums	curiculums
quartzites	quatites
merz	me
suri	sủi
arai	ẩi
guar	gủa
trussed	trused
buxom	buõm
vocs	vóc
chiropractors	cchiropractors
assaying	asaying
loran	loản
asap	ấp
coos	cố
arrondissement	arondissement
chuse	chué
gins	gín
soissons	soisons
usu	úu
assemblyman	asemblyman
irm	ỉm
nus	nú
essayists	esayists
masao	mấo
unrra	unra
oxo	ỗ
rist	rít
gana	gân
assimilative	asimilative
lox	lõ
ranga	râng
mowat	mơat
tisza	tia
messiaen	mesiaen
ose	oé
muons	muón
huss	hus
irreproachable	ireproachable
tarsi	tái
differencing	diferencing
oxidizer	oidier
bons	bón
caw	că
affectional	afectional
bassin	basin
bana	bân
narrations	narations
besser	beser
daud	đau
hangars	hấng
liana	liân
barres	bares
russie	rusie
rais	rái
dword	đưở
dessau	desau
haran	hẩn
arrowsmith	arowsmith
draupadi	ddraupadi
hira	hỉa
larissa	laisa
ussher	usher
dax	dã
bist	bít
dissonances	disonances
massless	masless
herringbone	heringbone
rosch	róch
aya	ây
chasse	chase
barracuda	baracuda
amf	àm
coffman	cofman
hepes	hếp
comr	cỏm
sujets	suét
emr	ẻm
khans	khán
assis	asis
leche	lêch
roasts	roát
damas	dấm
effervescence	efervescence
erf	è
harriot	hariot
bix	bĩ
dorrit	dorit
irri	iri
thats	thát
hansa	hấn
baas	bấ
powwow	powow
cocos	cốc
caja	cậ
kerrigan	kerigan
rojo	rộ
ninja	nịna
deeded	đdeeded
coot	côt
hijaz	hia
asso	aso
dees	dế
lorazepam	loaepam
rast	rát
mif	mì
sarat	sẩt
siete	siêt
busi	búi
suffragettes	sufragettes
carrasco	carasco
huffed	hufed
aws	ắ
corazon	coaon
ists	ít
coiffure	coifure
effervescent	efervescent
massy	masy
chlordiazepoxide	cchlordiazepoxide
cassian	casian
rar	rả
keren	kển
lesse	lese
boxwood	boõd
daya	dây
inj	ịn
trafford	traford
berm	bẻm
maurras	mauras
chiropractor	cchiropractor
phos	phó
moats	moát
kirghiz	kighi
cursus	cúu
cusa	cúa
tarried	taried
carats	cất
mers	mé
susy	suý
hopwood	hơpood
syr	sỷ
barua	bẩu
ressources	resources
assonance	asonance
garo	gảo
cori	cỏi
usw	ứ
boro	bổ
garrod	garod
suffragette	sufragette
orn	ỏn
doss	dos
hessen	hesen
mussen	musen
anf	àn
boos	bố
potawatomi	potăatomi
tdd	tđ
pyrrhotite	pyrhotite
diomedes	đdiomedes
orfeo	oèo
maar	mẩ
diffusible	difusible
irruption	iruption
duffield	dufield
coffer	cofer
hafez	hae
lajos	láo
marrakesh	marakesh
sere	sể
tene	tên
queers	quế
gassing	gasing
quips	quíp
deduces	đêúc
assen	asen
arriba	ariba
taw	tă
mouffe	moufe
duda	đua
tox	tõ
affectively	afectively
gaa	gâ
hums	húm
dux	dũ
unseeing	úunseeing
moir	mỏi
serres	seres
diene	diên
susana	suấn
saya	sây
correggio	coreggio
casus	cáu
affability	afability
murrell	murell
rafi	rài
acrs	ác
bassist	basist
esf	è
defused	đeùse
burros	buros
veers	vế
diarrheal	diarheal
quas	quá
terres	teres
iar	ỉa
dest	dét
affixing	afixing
harries	haries
russes	ruses
rossby	rosby
domo	dôm
mors	mó
oozes	oé
toots	tốt
vira	vỉa
goons	gốn
essene	esene
hoots	hốt
transshipment	transhipment
seest	sết
caisse	caise
assertively	asertively
giorno	giổn
raffle	rafle
nira	nỉa
suf	sù
ursa	úa
puisse	puise
disse	dise
coffeepot	cofeepot
lessors	lesors
swf	sừ
dori	dỏi
correctable	corectable
coxa	coã
nif	nì
duro	duỏ
thurow	thuở
nene	nên
massinger	masinger
pemex	pễm
harrap	harap
neces	nếc
corse	coé
cussed	cused
naso	náo
gor	gỏ
awt	ăt
buts	bút
wooldridge	wwooldridge
gussie	gusie
okw	ơk
gaffney	gafney
charac	chẩc
assholes	asholes
vars	vá
assignees	asignees
kir	kỉ
cassiodorus	casiodorus
lorn	lỏn
kis	kí
qw	qư
pwr	pử
caissons	caisons
horrocks	horocks
corroding	coroding
asaf	ầ
lesseps	leseps
raffia	rafia
lems	lém
acromioclavicular	ảcomioclavicular
carus	cáu
laisse	laise
casseroles	caseroles
beelzebub	belebub
vasc	vác
oxidizes	oidies
achr	ảch
effingham	efingham
oes	oé
irresponsibly	iresponsibly
currendy	curendy
geoffroy	geofroy
tussock	tusock
truffle	trufle
oot	ôt
mertz	met
auras	ấu
urizen	uien
dure	duẻ
transnationalism	ttransnationalism
chary	chảy
thyssen	thysen
afa	ầ
vassalage	vasalage
suffragist	sufragist
birren	biren
borromeo	boromeo
rijn	rịn
dus	dú
trots	trót
loons	lốn
hows	hớ
tots	tót
nonsmoking	nnonsmoking
bassoons	basoons
hydrochlorothiazide	hyđrochlorothiazie
affiliative	afiliative
bassa	basa
baru	bảu
coops	cốp
effectivity	efectivity
dissembling	disembling
ursus	úu
hasse	hase
chauffeurs	chaufeurs
aoa	âo
esch	éch
messe	mese
barzun	baun
gossiped	gosiped
transcaucasia	trtranscaucasia
hassell	hasell
mics	míc
cws	cứ
sassen	sasen
rossellini	rosellini
disaccharide	ddisaccharide
hertzberg	hetberg
thir	thỉ
ruffling	rufling
nass	nas
toon	tôn
tarai	tẩi
desc	déc
carryback	caryback
darf	dà
dafi	dài
ois	ói
birrell	birell
tiere	tiể
tufa	tùa
dorso	dố
maus	máu
barat	bẩt
berrigan	berigan
barratt	baratt
cachar	cẩch
neer	nể
basta	bất
mosm	móm
pharma	phẩm
hooray	hôảy
pws	pứ
rara	rẩ
chooser	chôér
messick	mesick
maja	mậ
massifs	masifs
assiduity	asiduity
corre	core
assenting	asenting
tows	tớ
duse	dué
disseminates	diseminates
batsman	bbatsman
pyrrhic	pyrhic
sirach	siảch
choson	chốn
roams	roám
torrington	torington
differance	diferance
bermudez	bemude
ero	ẻo
moxon	mỗn
horan	hoản
buffeting	bufeting
rusts	rút
barrages	barages
bassanio	basanio
irrationalism	irationalism
irreducibly	ireducibly
heros	héo
mims	mím
erec	ểc
correlator	corelator
gowan	gơan
buffets	bufets
hore	hoẻ
tanga	tâng
aussie	ausie
nasw	nắ
terranes	teranes
meps	mép
sats	sát
tias	tía
longwood	lơngood
hisself	hiself
burris	buris
assailing	asailing
lof	lò
hij	hị
laisser	laiser
arn	ản
menge	mêng
poon	pôn
affray	afray
gasser	gaser
ujjain	ujain
nisan	nián
barrelled	barelled
tress	tres
sorrento	sorento
ues	ué
tims	tím
aif	ài
lackawanna	lackăanna
dienes	diến
messerschmitt	meserschmitt
coro	cổ
essentia	esentia
lotos	lốt
ddp	đp
corry	cory
deme	dêm
yessir	yesir
sixteenthcentury	ssixteenthcentury
goer	goẻ
bary	bảy
diffusers	difusers
oso	ố
hussar	husar
irreligion	ireligion
ustr	ủt
iarc	iảc
narr	nar
massena	masena
aau	âu
tierras	tieras
luff	luf
assr	asr
hassler	hasler
casos	cáo
rost	rót
aam	âm
toffee	tofee
harriett	hariett
myr	mỷ
tej	tẹ
territorio	teritorio
bajra	bẩ
dacha	dâch
oort	ổt
pacha	pâch
earnshaw	earnshă
meech	mêch
gossipy	gosipy
lorrain	lorain
dorje	doẹ
osc	óc
assaultive	asaultive
lifshitz	lihit
hessians	hesians
gast	gát
terras	teras
barret	baret
asis	ái
maff	maf
assiniboine	asiniboine
gaur	gảu
irresolution	iresolution
arrowroot	arowroot
terris	teris
tosa	toá
owi	ơi
khurasan	khuấn
ansar	ánar
soffit	sofit
thorazine	thoaine
misr	mỉ
tono	tôn
vwf	vừ
cwc	cưc
afi	ài
chars	chá
lusk	lúk
eet	êt
leet	lêt
rix	rĩ
coffeehouses	cofeehouses
vdd	vđ
lowi	lơi
mums	múm
carryovers	caryovers
uts	út
mussulman	musulman
sops	sóp
laocoon	laocon
buffoonery	bufoonery
irradiating	iradiating
buffing	bufing
berra	bera
tissot	tisot
assemblymen	asemblymen
cwm	cưm
ansatz	anat
arawak	ẩk
merrimac	merimac
gyms	gým
borrelia	borelia
barraclough	baraclough
tost	tót
herm	hẻm
dess	des
berchtesgaden	bberchtesgaden
carriere	cariere
ruses	rué
gaf	gà
surratt	suratt
rescher	rểch
dessa	desa
essentiality	esentiality
verre	vere
miffed	mifed
suas	súa
carrol	carol
khas	khá
tyrrhenian	tyrhenian
rossman	rosman
affines	afines
disaccharides	ddisaccharides
vaso	váo
umw	ưm
dissemble	disemble
nips	níp
curfews	cưès
horas	hoá
nonfood	nonod
harz	ha
riffle	rifle
guyer	guyẻ
thioridazine	thioidaine
ganja	gận
sws	sứ
carrollton	carollton
affectations	afectations
sif	sì
larrabee	larabee
sassanian	sasanian
comoros	cổmos
harre	hare
bors	bó
bair	bải
russification	rusification
curries	curies
berridge	beridge
safford	saford
sufficiendy	suficiendy
pharos	pháo
tosi	tói
nays	náy
sexe	sễ
goof	gồ
pomo	pôm
tarrytown	tarytown
harriers	hariers
sers	sé
garrow	garow
meow	meơ
paar	pẩ
torrijos	torijos
puissant	puisant
tura	tủa
lasses	lases
morons	mốn
nono	nôn
terrae	terae
dioscorides	ddioscorides
hissar	hisar
boons	bốn
duds	đú
assocs	asocs
oms	óm
russett	rusett
visscher	vischer
muro	muỏ
tif	tì
uas	úa
ders	dé
tussen	tusen
terrance	terance
macaw	măc
cassady	casady
cassis	casis
rossa	rosa
nueces	nuếc
marryat	maryat
hys	hý
theorizes	theoies
diacritical	ddiacritical
loeffler	loefler
messiahs	mesiahs
doxa	doã
barras	baras
hopscotch	hhopscotch
bajaj	bậ
unfrozen	unoen
tessie	tesie
effulgence	efulgence
serratia	seratia
hussite	husite
irrecoverable	irecoverable
oom	ôm
vix	vĩ
haro	hảo
chasseurs	chaseurs
ests	ét
harrogate	harogate
lujan	luạn
theorization	theoiation
hejaz	hea
lier	liẻ
vips	víp
aai	âi
truax	trũa
oakwood	ơakood
tisch	tích
marris	maris
misspelling	mispelling
bessy	besy
ury	uỷ
dooms	dốm
transsexualism	transexualism
pwd	pưd
marfa	mầ
mier	miẻ
hinshaw	hínhă
itraconazole	itaconaole
massenet	masenet
pyrrole	pyrole
torricelli	toricelli
majus	máu
basi	bái
missourians	misourians
morozov	mmorozov
cama	câm
merrier	merier
misspellings	mispellings
lawbreakers	lăbreakers
dois	dói
oor	ổ
mux	mũ
arrington	arington
cof	cò
dorf	dò
horm	hỏm
asser	aser
nissl	nisl
nwfp	nừp
teem	têm
assents	asents
basswood	baswood
lwow	lươ
borromini	boromini
barringer	baringer
affordances	afordances
affronts	afronts
nof	nò
arraylist	araylist
daa	dâ
pdd	pđ
biarritz	biaritz
aaai	aai
besson	beson
huffing	hufing
giese	giế
awk	ăk
chara	chẩ
corrado	corado
misa	mía
veneered	venered
tarragona	taragona
masculinization	maculiniation
bursar	bủa
hyssop	hysop
heeft	hềt
ariz	ai
hest	hét
affinis	afinis
resorcinol	rresorcinol
hooch	hôch
risa	ría
assai	asai
coeff	coef
therm	thẻm
aaaa	aaa
bassi	basi
apf	àp
varnas	vấn
gossett	gosett
missis	misis
hormuz	homu
saxo	são
nuys	nuý
capsize	capie
soja	soạ
coef	coè
postindependence	ppostindependence
naya	nây
eer	ể
aspx	ãp
assurer	asurer
sensitizer	senitier
bdd	bđ
sese	sế
hijra	hỉa
curs	cú
effortful	efortful
carrageenan	carageenan
asat	ất
ruffed	rufed
mossi	mosi
recs	réc
beetroot	bbeetroot
ief	iè
churns	chún
vermes	vếm
khama	khâm
maat	mât
surry	sury
chiefest	chiết
homogenize	homgenie
affordably	afordably
boff	bof
decadal	đdecadal
hossain	hosain
ajc	ạc
mamas	mấm
cussing	cusing
tems	tém
herrington	herington
mox	mõ
paraformaldehyde	pparaformaldehyde
bassano	basano
curwen	cưẻn
cedaw	cedă
mansa	mấn
barna	bẩn
laa	lâ
vois	vói
chama	châm
safa	sầ
uris	úi
oon	ôn
barrell	barell
lussac	lusac
herren	heren
imr	ỉm
lais	lái
maffei	mafei
buret	buẻt
amj	ạm
chainsaw	chainsă
bafflement	baflement
usps	úp
danda	đân
tanah	tânh
heffernan	hefernan
taran	tẩn
carron	caron
chora	choả
diffractometer	difractometer
chur	chủ
assed	ased
errington	erington
terrifies	terifies
corrientes	corientes
densitometry	ddensitometry
roark	roảk
lese	lế
bots	bót
derricks	dericks
irrigations	irigations
lafferty	laferty
irredeemable	iredeemable
lowa	lơa
rosse	rose
gasses	gases
larus	láu
nias	nía
meses	mế
puer	puẻ
orrery	orery
tesserae	teserae
esm	ém
oost	ốt
reefer	rreefer
hese	hế
terrapin	terapin
cassy	casy
sasson	sason
nori	nỏi
giffard	gifard
assails	asails
deedee	đdeedee
liffey	lifey
effectuated	efectuated
eor	ẻo
duos	duó
tux	tũ
rosselli	roselli
corsi	cói
gari	gải
herrschaft	herschaft
marrakech	marakech
carracci	caracci
nats	nát
corriere	coriere
raffaele	rafaele
associativity	asociativity
oaf	oà
merrifield	merifield
borja	boạ
langs	láng
riffles	rifles
raiffa	raifa
tessier	tesier
terroristic	teroristic
hasa	hấ
harrods	harods
nux	nũ
bere	bể
corms	cóm
roszak	roak
phenelzine	phenline
ansa	ána
loris	lói
rans	rán
hussy	husy
curso	cuó
chere	chể
dims	dím
verrier	verier
correctives	corectives
terrazzo	terazzo
sachar	sẩch
suess	sues
rasta	rất
garrity	garity
nissim	nisim
mdd	mđ
hiaa	hiâ
kathiawar	kathiăar
thur	thủ
pongo	pông
daran	dẩn
maran	mẩn
lir	lỉ
riffs	rifs
vana	vân
trias	tría
nasolacrimal	nnasolacrimal
trost	trót
auffassung	aufassung
hacksaw	hacksă
cari	cải
dessins	desins
borst	bót
terrarium	terarium
misstep	mistep
rockaway	rockăay
daraus	dấu
cassiterite	casiterite
betrachtet	bbetrachtet
usus	úu
mussorgsky	musorgsky
usca	úca
musser	muser
durr	dur
etf	èt
aspasia	ápasia
duree	duể
sauf	sàu
musi	múi
desensitized	đênitie
macha	mâch
irrotational	irotational
efs	é
kes	ké
saur	sảu
affiant	afiant
towson	tốn
boj	bọ
teems	tếm
gir	gỉ
haf	hà
lesch	léch
thaf	thà
etr	ẻt
khor	khỏ
leered	lleered
cays	cáy
dissociations	disociations
raaf	rầ
mest	mét
ajzen	aen
assortments	asortments
garn	gản
differentiator	diferentiator
theos	théo
marranos	maranos
basch	bách
arrant	arant
iprs	íp
sacha	sâch
venezuelans	venuelans
erziehung	eiehung
barreto	bareto
masi	mái
mussulmans	musulmans
eres	ế
gierek	giểk
nusa	núa
mississauga	misissauga
verrocchio	verocchio
desmosomes	ddesmosomes
mwd	mưd
cowpox	cơpox
chos	chó
techs	téch
dej	dẹ
borno	bổn
missense	misense
dhammapada	ddhammapada
iasc	iác
hassall	hasall
hanssen	hansen
hoon	hôn
mufflers	muflers
kins	kín
kertesz	kêt
missives	misives
vias	vía
diffusivities	difusivities
suffixed	sufixed
saro	sảo
moana	moân
quires	quiẻs
arrestee	arestee
darrel	darel
quar	quả
serrate	serate
verry	very
bosse	bose
pana	pân
ddi	đi
narrativity	narativity
garrido	garido
sori	sỏi
susskind	suskind
muffling	mufling
gara	gẩ
pene	pên
serrata	serata
kerns	kén
associationism	asociationism
serried	seried
nisa	nía
nwp	nưp
maro	mảo
suhrawardy	suhrăardy
harrah	harah
derriere	deriere
guerres	gueres
booz	bo
decriminalization	deciminaliation
morais	moái
torrence	torence
terzaghi	teaghi
corrido	corido
inra	ỉna
raa	râ
husserlian	huserlian
awn	ăn
hcm	Hồ Chí Minh
arrogate	arogate
gujrat	guảt
kiran	kiản
irradiations	iradiations
marring	maring
nits	nít
tras	trá
soas	soá
affrighted	afrighted
espinoza	epinoa
sanga	sâng
euer	ểu
hooft	hồt
charring	charing
ossa	osa
diffuseness	difuseness
khana	khân
eets	ết
masc	mác
chor	chỏ
burs	bú
irst	ít
ifrs	í
chari	chải
kieffer	kiefer
poof	pồ
efe	ề
dard	đả
itf	ìt
dasaratha	ddasaratha
gaor	gảo
assimilable	asimilable
taff	taf
mussalmans	musalmans
transdisciplinary	trándisciplinary
tari	tải
berns	bén
usi	úi
morrie	morie
oaa	oâ
erreicht	ereicht
mene	mên
uart	uảt
vif	vì
dessous	desous
gams	gám
mississippians	misissippians
gaffer	gafer
derivatized	deivatied
hossein	hosein
camas	cấm
arrangers	arangers
thaws	thắ
harriette	hariette
mojo	mộ
duas	dúa
harrows	harows
qur	qủ
mossadegh	mosadegh
sorrell	sorell
charron	charon
mees	mế
uscs	úc
haart	hẩt
afsc	ác
musca	múca
buri	bủi
terrifyingly	terifyingly
arrowed	arowed
birr	bir
densitometer	dédensitometer
ressentiment	resentiment
demes	dếm
miers	mié
cassiopeia	casiopeia
mure	muẻ
ossicular	osicular
bori	bỏi
cassin	casin
demsetz	dêmt
bossing	bosing
verres	veres
harrold	harold
esos	éo
turan	tuản
usk	úk
saif	sài
siraj	sịa
baro	bảo
corrine	corine
rieff	rief
erez	ê
hasp	háp
nws	nứ
owa	ơa
terrill	terill
irredentist	iredentist
ausstellung	austellung
dusan	duán
viana	viân
anga	âng
diffractive	difractive
dono	dôn
menezes	mến
giffen	gifen
dacs	dác
caus	cáu
eero	ểo
sensitizers	senitiers
curragh	curagh
efferents	eferents
dufay	duày
sef	sè
gawk	găk
harrisonburg	harisonburg
irreducibility	ireducibility
correlatives	corelatives
correspondant	corespondant
dered	để
massiveness	masiveness
ches	ché
irresolvable	iresolvable
terza	tea
mossman	mosman
unfazed	unaed
charis	chái
essi	esi
herne	hển
merrymaking	merymaking
vais	vái
tury	tuỷ
riffraff	rifraff
guffaw	gufaw
irf	ì
rusch	rúch
cooch	côch
coj	cọ
gits	gít
corralled	coralled
corrugations	corugations
thuja	thụa
bwv	bưv
gies	gié
causas	cấu
homogenizer	homgenier
duer	duẻ
usis	úi
doffed	dofed
dessin	desin
rasselas	raselas
nanga	nâng
surprize	supie
irremediably	iremediably
osf	ò
messiness	mesiness
irrelevancies	irelevancies
taxus	táu
luso	luó
affably	afably
russkoi	ruskoi
harriss	hariss
dessalines	desalines
thiessen	thiesen
poissons	poisons
yere	yể
assi	asi
lacrimation	llacrimation
sora	soả
correia	coreia
coreldraw	coreldră
terran	teran
dimethylformamide	đimethylformamie
rassegna	rasegna
oroonoko	oổnko
assmann	asmann
lianas	liấn
transhumance	ttranshumance
transf	tràn
matrilocal	mmatrilocal
boussinesq	bousinesq
yx	ỹ
sasso	saso
gusset	guset
merrie	merie
husseini	huseini
dunaway	dunăay
coleslaw	coleslă
ossie	osie
ufw	ừ
assemblee	asemblee
diddle	didle
awwa	awa
erreur	ereur
lamaze	lame
berrien	berien
serre	sere
buffa	bufa
qwl	qưl
ress	res
uji	ụi
riss	ris
gierke	giẻke
tarrow	tarow
sasa	sấ
oooh	ooh
verrucous	verucous
nars	ná
erratum	eratum
essentiellement	esentiellement
buffoons	bufoons
sufficing	suficing
assassinating	asassinating
messiahship	mesiahship
garay	gẩy
mongo	mông
dodecanese	đdodecanese
hajji	haji
conj	cọn
soest	soét
pseudopodia	ppseudopodia
pauw	paư
chowk	chơk
marwan	mẩn
burridge	buridge
durrani	durani
arrighi	arighi
harrassowitz	harassowitz
codependent	ccodependent
ojt	ọt
assortative	asortative
sofer	soẻ
suraj	sụa
arrogated	arogated
ganj	gạn
effi	efi
monooxygenase	monoxygenase
danazol	danol
urrutia	urutia
chamar	chẩm
baji	bại
lairs	lái
lary	lảy
leffler	lefler
lipschitz	lipchit
terram	teram
lwr	lử
mischa	mícha
cassa	casa
mussed	mused
rias	ría
tums	túm
lissitzky	lisitzky
coif	còi
rosslyn	roslyn
seps	sép
narratology	naratology
gaffe	gafe
irradiate	iradiate
laffont	lafont
carrefour	carefour
mwanza	muana
gosselin	goselin
territoires	teritoires
affirmance	afirmance
homs	hóm
taproot	ttaproot
suffrages	sufrages
safi	sài
massawa	masawa
looses	lôés
irrelevancy	irelevancy
essentiel	esentiel
arrear	arear
khoo	khô
lesen	lến
guffawed	gufawed
carreras	careras
nere	nể
sarris	saris
nessa	nesa
henschel	hhenschel
terreno	tereno
anj	ạn
raffaello	rafaello
dorrie	dorie
gossypium	gosypium
masculinized	maculinied
bossed	bosed
howson	hốn
dorris	doris
peche	pêch
terrestris	terestris
associazione	asociazione
paca	pâc
bowra	bởa
gorst	gót
doms	dóm
assumpsit	asumpsit
ajnr	ản
laffer	lafer
homozygote	homygote
turreted	tureted
chosa	choá
irritative	iritative
soochow	sôchow
laissezfaire	laisezfaire
kisch	kích
ajay	ậy
transhepatic	ttranshepatic
sarna	sẩn
harar	hẩ
larix	lãi
burrito	burito
laparoscope	llaparoscope
etfs	ét
daddies	dadies
kyr	kỷ
hoffnung	hofnung
canr	cản
unsubsidized	unubsidied
thier	thiẻ
leszek	lêk
osservatore	oservatore
dusen	duén
benj	bẹn
mufioz	muio
dojo	dộ
massine	masine
affiliating	afiliating
barreling	bareling
aras	ấ
usna	úna
burrus	burus
irredeemably	iredeemably
burrough	burough
noss	nos
hoffmeister	hofmeister
marsyas	mấy
asan	ấn
naja	nậ
terracottas	teracottas
lndependent	llndependent
sems	sém
cofer	coẻ
lene	lên
irrigable	irigable
dese	dế
bisson	bison
hurrell	hurell
huis	húi
thys	thý
tuns	tún
bienes	biến
duffle	dufle
codependency	ccodependency
maji	mại
oooooooo	oooooo
gori	gỏi
irrigators	irigators
daan	dân
arrhythmic	arhythmic
pwn	pưn
giveaways	giveăays
sero	sẻo
diffi	difi
russischen	rusischen
tessellation	tesellation
mef	mè
doerr	doer
arrester	arester
caffe	cafe
effusively	efusively
burritos	buritos
laf	là
nari	nải
guis	gúi
hern	hẻn
russland	rusland
sechs	séch
mayaguez	maygue
carryforward	caryforward
pois	pói
dern	dẻn
quist	quít
roon	rôn
daffy	dafy
oems	oém
effec	efec
arrigo	arigo
massoud	masoud
hija	hịa
otr	ỏt
effluvia	efluvia
phasors	pháo
aor	ảo
sorrentino	sorentino
necromancer	nnecromancer
tiran	tiản
unspecialized	unpecialied
pierres	pieres
rassemblement	rasemblement
essent	esent
risse	rise
nier	niẻ
chana	chân
affixation	afixation
marz	ma
naif	nài
marra	mara
derringer	deringer
arroyos	aroyos
macaws	mắc
minx	mĩn
hojo	hộ
roff	rof
darrin	darin
lepromatous	llepromatous
oer	oẻ
lisse	lise
puissances	puisances
langa	lâng
enfer	èner
hongo	hông
ghaffar	ghafar
dox	dõ
dosi	dói
gorz	go
nachr	nảch
dudek	đuek
nees	nế
usaaf	uầ
barrault	barault
kier	kiẻ
osservazioni	oservazioni
sugawara	sugăara
rossignol	rosignol
unf	ùn
demers	dếm
messenia	mesenia
veneziano	veniano
maur	mảu
borrego	borego
corresp	coresp
assistantship	asistantship
massacring	masacring
barral	baral
basa	bấ
diffie	difie
herrero	herero
powis	pới
correo	coreo
terrifically	terifically
mero	mẻo
resocialization	reocialiation
burra	bura
durrant	durant
herrin	herin
harrowed	harowed
suffragan	sufragan
correll	corell
rauf	ràu
mys	mý
carrigan	carigan
coms	cóm
irreverently	ireverently
somos	sốm
lipsitz	lipit
osp	óp
asps	áp
dissects	disects
kessinger	kesinger
homozygosity	homygosity
issachar	isachar
daru	dảu
masseur	maseur
corruptly	coruptly
thessalian	thesalian
vins	vín
aji	ại
biran	biản
aua	âu
coots	cốt
differents	diferents
quickdraw	quickdră
boleslaw	boleslă
rur	rủ
asse	ase
thorez	thoe
terrestre	terestre
nossa	nosa
effectives	efectives
dosa	doá
vose	voé
transnationals	ttransnationals
lins	lín
rej	rẹ
vues	vué
ipf	ìp
baratz	bât
guffaws	gufaws
lecher	lểch
bursary	buảy
berri	beri
torno	tổn
casta	cất
vermicelli	vvermicelli
arrestees	arestees
hots	hót
buisson	buison
harran	haran
diarrhoeal	diarhoeal
coss	cos
corrodes	corodes
thej	thẹ
momo	môm
dussel	dusel
nessus	nesus
goro	gổ
nwc	nưc
teos	téo
locos	lốc
ays	áy
romo	rôm
stowaway	stowăay
lndependence	llndependence
lown	lơn
otf	òt
effectuation	efectuation
isf	ì
garratt	garatt
bassinet	basinet
lossing	losing
daws	dắ
associationist	asociationist
cassegrain	casegrain
coffeemaker	cofeemaker
bama	bâm
mirzapur	miapur
esk	ék
marriner	mariner
busk	búk
haffner	hafner
bwr	bử
casu	cáu
corrida	corida
missteps	misteps
correcdy	corecdy
transcaucasian	trtranscaucasian
laus	láu
botox	bỗt
basor	bảo
vasu	váu
thasos	tháo
lasse	lase
arriaga	ariaga
dorrance	dorance
terrine	terine
borns	bón
oxidizers	oidiers
usfs	ú
zw	zư
transmutations	ttransmutations
husak	huák
thefe	thề
doron	dổn
orizaba	oiaba
roop	rôp
russkogo	ruskogo
quanah	quânh
panas	pấn
leos	léo
rajneesh	rrajneesh
mij	mị
veroff	veof
tef	tè
ossificans	osificans
irredentism	iredentism
corm	cỏm
defmed	đềm
phips	phíp
bussey	busey
suso	suó
buffed	bufed
chamars	chấm
narratively	naratively
mussoorie	musoorie
oooooo	oooo
corrugation	corugation
denr	dẻn
hif	hì
reefed	rreefed
huw	hư
bex	bẽ
ossuary	osuary
mirra	mira
issus	isus
muri	mủi
bost	bót
heuer	hểu
surprized	supied
issac	isac
pooch	pôch
tiss	tis
heffer	hefer
gyr	gỷ
usf	ù
hussites	husites
phono	phôn
russkaia	ruskaia
nasca	nấc
thair	thải
rues	rué
coso	cố
differentes	diferentes
vassily	vasily
viens	vién
bisset	biset
associa	asocia
gassner	gasner
gwr	gử
lassa	lasa
hamar	hẩm
carretera	caretera
transrectal	ttransrectal
nwt	nưt
rosi	rói
dury	duỷ
anr	ản
coosa	cốa
chessman	chesman
affleck	afleck
utf	ùt
carra	cara
lessard	lesard
dissolutions	disolutions
sixteenths	ssixteenths
morss	mos
losch	lóch
rexx	rex
hertzian	hetian
tiefe	tiề
messinger	mesinger
xanax	xẫn
afo	ào