of	ò
is	í
as	á
this	thí
or	ỏ
his	hí
her	hẻ
has	há
there	thể
if	ì
been	bên
these	thế
its	ít
two	tươ
see	sê
most	mót
did	đi
how	hơ
those	thoé
now	nơ
must	mút
own	ơn
us	ú
down	dơn
here	hể
too	tô
thus	thú
less	les
law	lă
off	of
last	lát
best	bét
seen	sên
days	dáy
terms	tém
major	mảo
sense	sến
low	lơ
room	rôm
air	ải
term	tẻm
cost	cót
saw	să
test	tét
seems	sếm
basis	bái
turn	tủn
nor	nỏ
six	sĩ
soon	sôn
says	sáy
tax	tã
poor	pổ
lost	lót
loss	los
town	tơn
seem	sêm
door	dổ
rest	rét
list	lít
yes	yé
mass	mas
ask	ák
laws	lắ
meet	mêt
chief	chiè
sir	sỉ
der	dẻ
born	bỏn
box	bõ
car	cả
des	dé
despite	dépite
sex	sẽ
gas	gá
arms	ám
hair	hải
tree	trê
trust	trút
mary	mảy
piece	piêc
trees	trế
choose	chốe
miss	mis
les	lé
arm	ảm
bar	bả
coast	coát
chosen	choén
lies	lié
sets	sét
troops	trốp
los	ló
pieces	piếc
nineteenth	nnineteenth
queen	quên
mere	mể
chair	chải
root	rôt
cast	cát
sons	són
vast	vát
host	hót
theme	thêm
row	rơ
lee	lê
vary	vảy
rooms	rốm
moon	môn
turns	tún
axis	ái
towns	tớn
roots	rốt
poems	poém
usa	úa
ex	ẽ
sees	sế
chest	chét
raw	ră
lips	líp
trans	trán
runs	rún
honor	hổn
cars	cá
guess	gues
songs	sóng
dc	được
bus	bú
virus	víu
loans	loán
dust	dút
busy	buý
doors	dố
hero	hẻo
roof	rồ
verse	vế
chose	choé
lawrence	lăẻnce
loose	lốe
loop	lôp
est	ét
das	dá
corn	cỏn
harm	hảm
res	ré
max	mã
mix	mĩ
tons	tón
dans	dán
guns	gún
maps	máp
dad	đa
themes	thếm
es	é
bias	bía
marx	mã
ties	tié
norms	nóm
phys	phý
defend	đền
thee	thê
moore	mổe
sur	sủ
lots	lót
beer	bể
refuse	reùse
bars	bá
poets	poét
rays	ráy
las	lá
lens	lén
er	ẻ
ix	ĩ
bits	bít
rats	rát
moses	moé
boats	boát
dawn	dăn
thereof	thềo
susan	suán
burst	bút
bow	bơ
guest	guét
rows	rớ
buyer	buyẻ
ross	ros
tries	trié
cheese	chếe
burn	bủn
cuts	cút
kiss	kis
peer	pể
boss	bos
chiefs	chié
dense	dến
pays	páy
guys	guý
horn	hỏn
quest	quét
meets	mết
sins	sín
arizona	aiona
deer	dể
dies	dié
ist	ít
trips	tríp
chaos	cháo
chairs	chái
cow	cơ
burns	bún
torn	tỏn
tips	típ
peers	pế
hans	hán
deeds	đế
hers	hé
norm	nỏm
vis	ví
tariff	taif
rests	rét
carcinoma	cảcinoma
lungs	lúng
tense	tến
norway	nơảy
nest	nét
bass	bas
deed	đê
keen	kên
cups	cúp
beef	bề
donor	dổn
noon	nôn
boots	bốt
laura	lẩu
ar	ả
quasi	quái
sums	súm
boom	bôm
dos	dó
cats	cát
mama	mâm
mcgraw	mcgră
ins	ín
charm	chảm
ieee	iee
ref	rè
auf	àu
buyers	buyé
os	ó
gary	gảy
mess	mes
aa	â
straw	stră
sits	sít
daddy	đady
cows	cớ
gaps	gáp
ir	ỉ
lest	lét
mar	mả
ass	as
doorway	dơảy
nuts	nút
nineteen	nnineteen
mars	má
barn	bản
bis	bí
ser	sẻ
lets	lét
ups	úp
chips	chíp
aus	áu
quartz	quat
curse	cué
burma	bủma
lawn	lăn
chooses	chôés
cox	cõ
nos	nó
refuses	reùses
cues	cué
aux	ãu
irs	í
bee	bê
poorer	pôẻr
boot	bôt
diana	diân
lisa	lía
maya	mây
toes	toé
var	vả
tops	tóp
moss	mos
loops	lốp
sara	sẩ
terminate	tẻminate
luis	lúi
hits	hít
owns	ớn
mist	mít
tor	tỏ
cor	cỏ
taxi	tãi
pierce	piểc
guru	gủu
tis	tí
horns	hón
venezuela	venuela
tens	tén
bees	bế
imf	ìm
buses	bué
nasa	nấ
rosa	roá
choir	chỏi
hips	híp
lust	lút
reef	rề
donors	dốn
hats	hát
ses	sé
gown	gơn
af	à
coats	coát
thirst	thít
diets	diét
dots	dót
hawk	hăk
traps	tráp
sofa	soà
mais	mái
esp	ép
caps	cáp
turbulence	tủbulence
tore	toẻ
thief	thiè
xix	xĩ
goats	goát
bury	buỷ
hairs	hái
troop	trôp
myers	myé
nets	nét
queer	quể
mast	mát
boost	bốt
ngos	ngó
cans	cán
oo	ô
conf	còn
teen	tên
teens	tến
lays	láy
como	côm
honors	hốn
tier	tiẻ
roofs	rố
roar	roả
sans	sán
cas	cá
sworn	sưởn
homo	hôm
eec	êc
lasts	lát
tar	tả
mis	mí
afro	ảo
ox	õ
goose	gốe
pier	piẻ
chess	ches
buys	buý
barcelona	bảcelona
visa	vía
bosom	bốm
cos	có
nuns	nún
casts	cát
carr	car
hast	hát
cheer	chể
nests	nét
aura	ẩu
dwarf	dừa
toast	toát
apr	ảp
queens	quến
downs	dớn
cops	cóp
raja	rậ
dams	dám
nur	nủ
hist	hít
rama	râm
yr	ỷ
char	chả
dir	dỉ
gangs	gáng
ere	ể
ax	ã
dues	dué
huts	hút
rust	rút
chores	choé
dana	dân
coasts	coát
boast	boát
toss	tos
mw	mư
doom	dôm
ee	ê
rex	rẽ
bust	bút
niece	niêc
dyes	dyé
surf	sù
sw	sư
rene	rên
ef	è
nw	nư
sess	ses
morse	moé
hangs	háng
bois	bói
ness	nes
ans	án
dar	dả
dow	dơ
vow	vơ
ter	tẻ
roast	roát
nora	noả
herr	her
mas	má
casa	cấ
bows	bớ
www	ww
kerr	ker
urn	ủn
aj	ạ
turf	tù
mir	mỉ
sown	sơn
oj	ọ
dee	dê
charms	chám
vows	vớ
gujarat	guẩt
dist	dít
boris	bói
laos	láo
raj	rạ
oats	oát
thorn	thỏn
chef	chè
ko	không
doris	dói
oxen	oẽn
ther	thẻ
quart	quảt
sow	sơ
bats	bát
lor	lỏ
lois	lói
benevolence	bênvolence
loom	lôm
sus	sú
ooo	oo
gis	gí
cons	cón
piers	pié
majors	máo
loaf	loà
vest	vét
burr	bur
pius	píu
tow	tơ
dd	đ
reefs	rế
dass	das
vor	vỏ
aw	ă
cuff	cuf
ras	rá
lama	lâm
tee	tê
muse	mué
beset	bết
moor	mổ
ur	ủ
mats	mát
bays	báy
cass	cas
deem	dêm
kw	kư
asa	ấ
diese	diế
liar	lỉa
deduce	đêuc
boer	boẻ
hess	hes
barr	bar
boron	bổn
mer	mẻ
sachs	sách
sarcoma	sảcoma
gaas	gấ
dora	doả
boon	bôn
moose	mốe
neue	nêu
hirsch	hích
ber	bẻ
een	ên
mono	môn
cheers	chế
sas	sá
torso	tố
trays	tráy
taxa	tẫ
cw	cư
mus	mú
dodd	đod
bas	bá
guts	gút
asp	áp
gus	gú
nero	nẻo
nee	nê
tara	tẩ
inf	ìn
verso	véo
aaa	aa
eros	éo
thorax	thoã
chaps	cháp
moran	moản
muir	mủi
looms	lốm
dieser	diể
moors	mố
ver	vẻ
respite	répite
loosen	lôén
beech	bêch
hawks	hắk
bose	boé
afar	ẩ
outlaw	outlă
mos	mó
beet	bêt
resurgence	reúrgence
norepinephrine	noẻpinephrine
raf	rà
oasis	oái
sis	sí
dyer	dyẻ
thorns	thón
bern	bẻn
yer	yẻ
uss	us
ddt	đt
hens	hén
boxer	boẻ
tres	tré
err	er
buff	buf
paw	pă
hasan	hấn
cary	cảy
lax	lã
lex	lẽ
hays	háy
defends	đến
taps	táp
hiss	his
boar	boả
kits	kít
def	dè
hermes	hếm
hertz	het
chests	chét
tess	tes
lawns	lắn
beers	bế
diss	dis
pies	pié
vers	vé
rees	rế
har	hả
lis	lí
ems	ém
nana	nân
sar	sả
hier	hiẻ
trojan	troạn
rw	rư
gasp	gáp
boasts	boát
trois	trói
bur	bủ
voor	vổ
gauss	gaus
haas	hấ
barns	bán
thaw	thă
airs	ái
tiers	tié
gums	gúm
ars	á
kern	kẻn
seer	sể
dod	đo
museo	muéo
bess	bes
berne	bển
mes	mé
gays	gáy
musee	muế
ej	ẹ
sono	sôn
netscape	nétcape
bets	bét
jw	jư
dw	dư
buren	buẻn
horowitz	hơit
chow	chơ
xerox	xẽo
quran	quản
noir	nỏi
uns	ún
hues	hué
hoop	hôp
gowns	gớn
cora	coả
vas	vá
liszt	lit
reese	rếe
deems	dếm
ww	wư
unrecognized	unecognied
yrs	ý
misc	míc
oars	oá
soot	sôt
dost	dót
sufi	sùi
ism	ím
sox	sõ
iff	if
tris	trí
dura	dủa
huron	huỏn
rowan	rơan
harms	hám
ers	é
visas	vía
russ	rus
mara	mẩ
nas	ná
serfs	sé
duff	duf
moons	mốn
muses	mué
dix	dĩ
refs	ré
virulence	viủlence
bor	bỏ
bosch	bóch
chasm	chám
voir	vỏi
mori	mỏi
tex	tẽ
hiram	hiảm
truss	trus
vos	vó
sens	sén
norse	noé
bins	bín
cowan	cơan
hee	hê
vn	Việt Nam
soar	soả
gist	gít
boers	boé
liens	lién
ics	íc
orr	or
ij	ị
boas	boá
meme	mêm
hurst	hút
okinawa	okinăa
taxis	tái
rosary	roảy
docs	dóc
hops	hóp
dips	díp
dwarfs	dứa
pow	pơ
loo	lô
casas	cấ
ecr	ẻc
masts	mát
loot	lôt
mists	mít
tokugawa	tokugăa
durand	đuản
heme	hêm
uf	ù
pharm	phảm
ara	ẩ
eps	ép
hari	hải
ganga	gâng
curr	cur
reorganize	reoganie
tins	tín
oar	oả
quark	quảk
ons	ón
boo	bô
doorways	dơáy
bene	bên
pw	pư
moot	môt
pawn	păn
acs	ác
dada	đâ
emf	èm
rams	rám
sys	sý
denser	dển
chore	choẻ
lori	lỏi
causa	cấu
ow	ơ
mora	moả
mari	mải
ops	óp
therese	thếe
rims	rím
truer	truẻ
musa	múa
rana	rân
chops	chóp
suis	súi
renee	rene
usc	úc
baja	bậ
isp	íp
soaps	soáp
gust	gút
lara	lẩ
longs	lóng
hoof	hồ
mens	mén
torr	tor
ture	tuẻ
gw	gư
lass	las
beets	bết
oas	oá
duress	dues
lars	lá
ams	ám
cusp	cúp
hausa	hấu
hosp	hóp
leech	lêch
mor	mỏ
theseus	thếu
vans	ván
lees	lế
oro	ổ
ari	ải
nara	nẩ
oss	os
osi	ói
mira	mỉa
pee	pê
busch	búch
horst	hót
ruse	rué
mays	máy
trieste	triết
thor	thỏ
ies	ié
gar	gả
mans	mán
ess	es
nineteenthcentury	nnineteenthcentury
suns	sún
trier	triẻ
tw	tư
coop	côp
vere	vể
lisp	líp
ifn	ìn
bw	bư
aix	ãi
mirza	mia
hereof	hềo
saws	sắ
uri	ủi
dif	dì
caro	cảo
transmembrane	tránmembrane
lamar	lẩm
bari	bải
dude	đue
dirac	diảc
chakra	chảka
curfew	cừe
sacs	sác
cara	cẩ
vero	vẻo
ajax	ẫ
bono	bôn
ips	íp
booze	boe
geoff	geof
dieses	diế
esr	ẻ
ree	rê
casablanca	cấblanca
caso	cáo
taos	táo
tes	té
dorm	dỏm
esc	éc
suarez	suae
laps	láp
rasa	rấ
hasta	hất
tern	tẻn
moser	moẻ
terse	tế
reps	rép
syst	sýt
loess	loes
morn	mỏn
surat	suảt
lux	lũ
vir	vỉ
mons	món
sax	sã
ias	ía
ros	ró
trajan	trận
coo	cô
neuen	nêun
didst	đít
cur	củ
chiapas	chiấp
chefs	ché
coon	côn
seers	sế
bos	bó
chaff	chaf
sos	só
nis	ní
moro	mổ
tarn	tản
samaj	sậm
ast	át
loco	lôc
lans	lán
rus	rú
dens	dén
hn	Hà Nội
bir	bỉ
mana	mân
truest	truét
booms	bốm
bans	bán
somoza	soma
diesem	diếm
bursa	búa
roost	rốt
hoax	hoã
mins	mín
lows	lớ
senescence	sếncence
aps	áp
epr	ẻp
nurs	nú
choirs	chói
hangar	hẩng
hoops	hốp
osmosis	ómosis
noose	nốe
gif	gì
mee	mê
huff	huf
sari	sải
hors	hó
haw	hă
nox	nõ
lys	lý
ifs	í
moritz	moit
uaw	uă
hoofs	hố
mow	mơ
asi	ái
dais	dái
tarsus	táu
tas	tá
taro	tảo
sor	sỏ
ys	ý
fw	fư
doer	doẻ
ims	ím
retrace	rẻtace
desde	đế
hara	hẩ
lair	lải
cosa	coá
gaap	gâp
ets	ét
vw	vư
bums	búm
anwar	ănar
lar	lả
looser	lôér
tongs	tóng
liars	lía
arya	ẩy
bangs	báng
verne	vển
irma	ỉma
nieces	niếc
hw	hư
quirk	quỉk
coax	coã
aas	ấ
asm	ám
usaf	ùa
resp	rép
ens	én
tics	tíc
iss	is
moms	móm
lynx	lỹn
choctaw	choctă
soo	sô
dias	día
eos	éo
dore	doẻ
busts	bút
monopolize	monpolie
sixpence	sĩpence
deren	dển
dwyer	dưyẻ
hos	hó
serf	sè
ecj	ẹc
darn	dản
meer	mể
vests	vét
aan	ân
ajar	ẩ
ary	ảy
coco	côc
thorac	thoảc
dido	đio
heen	hên
marr	mar
lana	lân
mies	mié
hirst	hít
doran	doản
urns	ún
loon	lôn
eff	ef
choses	choé
lusaka	luáka
huns	hún
lw	lư
voss	vos
moans	moán
hoff	hof
peshawar	peshăar
tamar	tẩm
sows	sớ
cher	chẻ
inlaw	inlă
gama	gâm
rojas	roá
loro	lổ
ese	ế
hoo	hô
corr	cor
kee	kê
congr	cỏng
irr	ir
rostow	rớt
corso	cố
gusts	gút
lysozyme	lyoyme
diff	dif
dade	đae
hamas	hấm
toro	tổ
quits	quít
nots	nót
boxers	boé
noaa	noâ
afm	àm
maj	mạ
taj	tạ
cusps	cúp
misra	mỉa
didn	đin
ost	ót
poco	pôc
tiene	tiên
twos	tướ
arf	à
nes	né
nair	nải
dor	dỏ
ucs	úc
diesen	diến
haji	hại
doo	dô
basu	báu
squaw	squă
ker	kẻ
tori	tỏi
mots	mót
bier	biẻ
trojans	troán
duran	duản
lias	lía
tur	tủ
ner	nẻ
rajya	rậy
afr	ả
dorado	đoảo
veer	vể
puis	púi
uj	ụ
dorn	dỏn
gasps	gáp
moo	mô
haus	háu
moray	moảy
exe	ễ
tuff	tuf
ust	út
ghee	ghê
chas	chá
ruff	ruf
churn	chủn
lusts	lút
termite	tẻmite
ius	íu
mair	mải
aia	âi
vasquez	vaque
caa	câ
mex	mẽ
icj	ịc
sars	sá
hus	hú
meso	méo
venezia	venia
maw	mă
thar	thả
mujer	muẻ
nyerere	nyểe
terns	tén
nasir	nải
buns	bún
rungs	rúng
lif	lì
tues	tué
soes	soé
husayn	huáyn
roars	roá
roms	róm
bakr	bảk
goff	gof
saar	sẩ
iaa	iâ
liss	lis
tits	tít
puja	pụa
nics	níc
sura	sủa
ipsa	ípa
pawnee	pănee
sofas	soá
xerxes	xế
varna	vẩn
maris	mái
mets	mét
ooze	oe
sawn	săn
sujet	suẹt
usp	úp
nama	nâm
dur	dủ
chir	chỉ
vox	võ
basra	bẩ
dodds	đods
asch	ách
lamas	lấm
usr	ủ
reste	rết
barak	bẩk
cots	cót
dons	dón
oversaw	oversă
mesure	meúre
buss	bus
asc	ác
nar	nả
bora	boả
hajj	haj
toms	tóm
deere	dểe
vaux	vãu
erst	ét
mayr	mảy
hermione	hẻmione
chee	chê
terme	tểm
yee	yê
lira	lỉa
theorize	theoie
gans	gán
hora	hoả
hoary	hoảy
naa	nâ
benes	bến
masai	mấi
roos	rố
byers	byé
hams	hám
borax	boã
dusts	dút
loos	lố
thais	thái
vats	vát
mawr	mẳ
oxidize	oidie
ais	ái
herz	he
chats	chát
hor	hỏ
morass	moas
toasts	toát
dodson	đốn
ocr	ỏc
sama	sâm
aswan	ấn
sams	sám
vax	vã
theor	thẻo
aff	af
eso	éo
laszlo	lalo
defuse	deùse
doers	doé
sufis	súi
cura	của
mois	mói
gaya	gây
uw	ư
iww	iw
maru	mảu
unrecognizable	unecogniable
ris	rí
maas	mấ
goss	gos
vee	vê
naw	nă
hoot	hôt
hoar	hoả
ves	vé
eretz	êt
uar	ủa
poop	pôp
goo	gô
ruts	rút
vasa	vấ
garza	gâ
duns	dún
ors	ó
arr	ar
sips	síp
dara	dẩ
thess	thes
ler	lẻ
tana	tân
cosmo	cốm
hoes	hoé
aro	ảo
monogr	mổng
maura	mẩu
sirs	sí
tos	tó
ats	át
cwt	cưt
thos	thó
erm	ẻm
neff	nef
tof	tò
tees	tế
rosas	roá
muss	mus
marais	mấi
stanislaw	stanislă
ipr	ỉp
sues	sué
hir	hỉ
leer	lể
usn	ún
tyr	tỷ
cams	cám
beret	bểt
orsay	oáy
mof	mò
mauss	maus
amr	ảm
hana	hân
baa	bâ
saa	sâ
murat	muảt
aram	ẩm
ries	rié
bij	bị
gur	gủ
ospf	òp
rer	rẻ
mujeres	muế
trams	trám
ocs	óc
varus	váu
ori	ỏi
dari	dải
dawns	dắn
varma	vẩm
ishikawa	ishikăa
thieme	thiêm
bask	bák
neues	nếu
iwo	iươ
aiaa	aia
nir	nỉ
hof	hò
dads	đá
durst	dút
manas	mấn
tors	tó
vara	vẩ
naps	náp
quests	quét
ipx	ĩp
dowd	đơ
roo	rô
hur	hủ
hons	hón
vern	vẻn
voix	või
cana	cân
saginaw	sagină
eof	èo
norsk	nók
ajr	ả
secs	séc
tass	tas
sais	sái
isps	íp
charan	chẩn
naca	nâc
dijk	dịk
lors	ló
quasars	quấ
nist	nít
nuer	nuẻ
muerte	muểt
goers	goé
bast	bát
banff	banf
vaca	vâc
poore	pổe
quis	quí
bedridden	beđriden
chins	chín
marat	mẩt
bajo	bạo
chakras	chảkas
iw	iư
pues	pué
phasor	phảo
bara	bẩ
tiff	tif
dde	đe
gooch	gôch
asr	ả
pierces	piếc
tus	tú
surfers	sué
termes	tếm
horwitz	hơit
doren	doẻn
soars	soá
thurs	thú
ques	qué
thiers	thié
nasr	nả
ecs	éc
chickasaw	chickasă
vari	vải
itr	ỉt
atr	ảt
dado	đao
susa	súa
riff	rif
isr	ỉ
maa	mâ
paa	pâ
ier	iẻ
surfer	suẻ
deuce	dêuc
gats	gát
chirac	chiảc
kinshasa	kínhasa
rips	ríp
cose	coé
meerut	mêủt
risc	ríc
monro	mổn
gethsemane	géthemane
rickshaw	rickshă
nowak	nơak
kirsch	kích
marys	máy
ogawa	ogăa
kershaw	kershă
saps	sáp
neuer	nểu
saf	sà
yerkes	yẻkes
unfree	ủnee
macs	mác
hermaphrodite	hẻmaphrodite
mur	mủ
moos	mố
bierce	biểc
icr	ỉc
moron	mổn
baur	bảu
dodo	đô
hes	hé
vier	viẻ
echr	ẻch
darfur	dảu
duets	duét
boars	boá
manga	mâng
homogenate	hômgenate
hurwitz	hưit
poo	pô
hafiz	hai
heer	hể
bax	bã
raya	rây
haya	hây
isms	ím
aac	âc
cosas	coá
dorr	dor
thongs	thóng
nomos	nốm
transience	tránience
choo	chô
kiefer	kiể
hoss	hos
gass	gas
casi	cái
haar	hẩ
mayas	mấy
hofer	hoẻ
vajra	vẩ
mose	moé
mesures	meúres
luxor	luỏ
boson	bốn
myer	myẻ
nies	nié
oops	ốp
dorsi	dói
raju	rạu
nix	nĩ
sosa	soá
ux	ũ
cwa	cưa
kira	kỉa
rasp	ráp
bes	bé
dex	dẽ
daw	dă
tures	tué
mura	mủa
bulawayo	bulăayo
longo	lông
dere	dể
tomo	tôm
ecf	èc
naar	nẩ
oozed	oed
aran	ẩn
thana	thân
hasegawa	hasegăa
iee	iê
dorms	dóm
baca	bâc
vex	vẽ
ddc	đc
raff	raf
neem	nêm
tir	tỉ
urs	ú
coxe	coẽ
ters	té
soir	sỏi
tama	tâm
lacs	lác
asf	à
engrs	éng
lix	lĩ
quays	quáy
kips	kíp
nary	nảy
sira	sỉa
biff	bif
tener	tển
howitzer	hoiter
nuri	nủi
derm	dẻm
ufa	ùa
rajan	rận
dene	dên
saran	sẩn
haan	hân
vermiculite	vẻmiculite
xor	xỏ
luxe	luẽ
soong	sông
duras	dúa
aos	áo
lasch	lách
dwt	dưt
vets	vét
masa	mấ
keefe	kềe
bef	bè
nast	nát
tamas	tấm
asn	án
isc	íc
atf	àt
coram	coảm
bosco	bốc
meese	mếe
rif	rì
viene	viên
choix	chõi
inr	ỉn
gnaw	gnă
rots	rót
carat	cẩt
tojo	tộ
aarp	ẩp
giri	giỉ
menger	mểng
sensitize	senitie
corns	cón
bers	bé
durer	duẻ
sana	sân
sarai	sẩi
aris	ái
gongs	góng
aja	ậ
tans	tán
baran	bẩn
becher	bểch
ietf	ièt
aaf	ầ
haj	hạ
mips	míp
gos	gó
manx	mãn
redraw	redră
hurons	huón
chiasm	chiám
toot	tôt
berets	bết
yf	ỳ
dds	đs
ees	ế
sass	sas
oxon	ỗn
cus	cú
truro	truỏ
sof	sò
ozawa	ozăa
satsuma	sátuma
lora	loả
asw	ắ
ror	rỏ
oop	ôp
gorse	goé
darya	dẩy
darauf	dầu
saarc	sẩc
ern	ẻn
oeec	oêc
orm	ỏm
oooo	oô
maxi	mãi
tirpitz	tipit
daro	dảo
noor	nổ
memes	mếm
gow	gơ
eez	e
kisan	kián
ded	đe
hass	has
khasi	khái
orf	ò
raps	ráp
gora	goả
naf	nà
saks	sák
corsair	coải
dda	đa
acr	ảc
aar	ẩ
vies	vié
cuss	cus
ucr	ủc
trims	trím
kharif	khài
seesaw	sếă
nasi	nái
coons	cốn
quire	quiẻ
buf	bù
gurr	gur
gaff	gaf
icf	ìc
dof	dò
queste	quết
maf	mà
quern	quẻn
ots	ót
seme	sêm
samar	sẩm
ayr	ảy
ojo	ộ
taa	tâ
sejm	sẹm
saris	sái
taux	tãu
exo	ẽo
rejuvenate	reụvenate
tanf	tàn
yj	ỵ
acf	àc
terr	ter
trist	trít
dasa	dấ
aur	ảu
aap	âp
mesmer	mểm
mops	móp
tars	tá
byes	byé
sarma	sẩm
goran	goản
quos	quó
basf	bà
nys	ný
dyers	dyé
mejor	mẻo
tary	tảy
aso	áo
ruf	rù
morarji	moại
engr	ẻng
doon	dôn
tryst	trýt
onr	ỏn
rasch	rách
kyrgyz	kygy
coir	cỏi
nayar	nẩy
cosi	cói
hwa	hưa
cust	cút
eeo	êo
ddd	đd
daf	dà
oris	ói
ifr	ỉ
haa	hâ
ura	ủa
quasar	quẩ
ddl	đl
marzo	mao
diener	diển
hori	hỏi
soaks	soák
dud	đu
moores	môẻs
mown	mơn
nef	nè
afs	á
chums	chúm
rois	rói
uwe	ưe
veen	vên
pwm	pưm
kurosawa	kurosăa
biens	bién
leff	lef
sary	sảy
dowson	dốn
noirs	nói
isn	ín
coser	coẻ
chasms	chám
lef	lè
lus	lú
tarr	tar
boor	bổ
misma	míma
corot	cổt
doj	dọ
ojos	ố
henshaw	hénhă
eee	ee
dede	đê
escher	ểch
deen	dên
caf	cà
apj	ạp
nawaz	na
marya	mẩy
bylaw	bylă
ooooo	ooo
bongo	bông
haram	hẩm
noo	nô
muff	muf
corsairs	coái
astr	ảt
tora	toả
hama	hâm
roxas	roá
goon	gôn
aat	ât
veces	vếc
iaf	ìa
hefner	hển
arif	ài
noms	nóm
peet	pêt
hopf	hòp
aircrew	aỉcew
naxos	náo
laidlaw	laidlă
pwa	pưa
thins	thín
dudes	đué
thes	thé
coors	cố
hox	hõ
bufo	buò
dama	dâm
senge	sêng
murata	muẩt
dinwiddie	đinwidie
kees	kế
taf	tà
lief	liè
trow	trơ
haps	háp
renshaw	rénhă
nakagawa	nakagăa
loams	loám
nore	noẻ
merz	me
suri	sủi
arai	ẩi
guar	gủa
buxom	buõm
vocs	vóc
loran	loản
asap	ấp
coos	cố
chuse	chué
gins	gín
usu	úu
irm	ỉm
carmina	cảmina
nus	nú
masao	mấo
oxo	ỗ
rist	rít
gana	gân
lox	lõ
ranga	râng
mowat	mơat
tisza	tia
ose	oé
muons	muón
huss	hus
tarsi	tái
bons	bón
caw	că
bana	bân
diphenhydramine	điphenhyramine
hangars	hấng
liana	liân
rais	rái
dword	đưở
haran	hẩn
hira	hỉa
dax	dã
bist	bít
rosch	róch
aya	ây
amf	àm
hepes	hếp
comr	cỏm
sujets	suét
emr	ẻm
khans	khán
leche	lêch
roasts	roát
damas	dấm
erf	è
bix	bĩ
thats	thát
hansa	hấn
baas	bấ
cocos	cốc
caja	cậ
rojo	rộ
ninja	nịna
coot	côt
hijaz	hia
dees	dế
rast	rát
mif	mì
sarat	sẩt
siete	siêt
busi	búi
aws	ắ
ists	ít
kanagawa	kanagăa
rar	rả
keren	kển
daya	dây
inj	ịn
berm	bẻm
phos	phó
moats	moát
kirghiz	kighi
cursus	cúu
cusa	cúa
carats	cất
mers	mé
susy	suý
hopwood	hơpood
syr	sỷ
barua	bẩu
garo	gảo
cori	cỏi
usw	ứ
boro	bổ
orn	ỏn
doss	dos
anf	àn
boos	bố
yoshikawa	yoshikăa
orfeo	oèo
maar	mẩ
hafez	hae
lajos	láo
sere	sể
tene	tên
queers	quế
quips	quíp
deduces	đêúc
taw	tă
duda	đua
tox	tõ
gaa	gâ
hums	húm
dux	dũ
moir	mỏi
diene	diên
susana	suấn
saya	sây
casus	cáu
rafi	rài
acrs	ác
esf	è
defused	đeùse
veers	vế
quas	quá
iar	ỉa
dest	dét
domo	dôm
mors	mó
oozes	oé
toots	tốt
ichikawa	ichikăa
vira	vỉa
goons	gốn
hoots	hốt
seest	sết
giorno	giổn
nira	nỉa
suf	sù
ursa	úa
swf	sừ
dori	dỏi
coxa	coã
nif	nì
duro	duỏ
thurow	thuở
nene	nên
pemex	pễm
neces	nếc
corse	coé
naso	náo
gor	gỏ
awt	ăt
buts	bút
okw	ơk
charac	chẩc
vars	vá
kir	kỉ
lorn	lỏn
kis	kí
qw	qư
pwr	pử
choriocarcinoma	chôỉcarcinoma
asaf	ầ
lems	lém
acromioclavicular	ảcomioclavicular
carus	cáu
vasc	vác
achr	ảch
oes	oé
oot	ôt
mertz	met
auras	ấu
dure	duẻ
chary	chảy
afa	ầ
rijn	rịn
dus	dú
trots	trót
loons	lốn
hows	hớ
tots	tót
hydrochlorothiazide	hyđrochlorothiazie
baru	bảu
coops	cốp
ursus	úu
aoa	âo
esch	éch
mics	míc
cws	cứ
thir	thỉ
nass	nas
toon	tôn
tarai	tẩi
desc	déc
darf	dà
dafi	dài
ois	ói
tiere	tiể
tufa	tùa
dorso	dố
maus	máu
barat	bẩt
cachar	cẩch
neer	nể
basta	bất
mosm	móm
pharma	phẩm
hooray	hôảy
pws	pứ
rara	rẩ
chooser	chôér
maja	mậ
tows	tớ
duse	dué
sirach	siảch
choson	chốn
roams	roám
bermudez	bemude
ero	ẻo
moxon	mỗn
horan	hoản
rusts	rút
heros	héo
mims	mím
erec	ểc
gowan	gơan
hore	hoẻ
tanga	tâng
nasw	nắ
meps	mép
sats	sát
tias	tía
longwood	lơngood
lof	lò
hij	hị
arn	ản
menge	mêng
poon	pôn
midnineteenth	mmidnineteenth
teste	tết
nisan	nián
tress	tres
ues	ué
tims	tím
aif	ài
dienes	diến
coro	cổ
lotos	lốt
ddp	đp
deme	dêm
goer	goẻ
bary	bảy
oso	ố
ustr	ủt
iarc	iảc
narr	nar
aau	âu
luff	luf
decerebrate	dểcebrate
casos	cáo
rost	rót
aam	âm
myr	mỷ
tej	tẹ
bajra	bẩ
dacha	dâch
oort	ổt
pacha	pâch
earnshaw	earnshă
meech	mêch
dorje	doẹ
osc	óc
lifshitz	lihit
gast	gát
asis	ái
kitagawa	kitagăa
maff	maf
gaur	gảu
kanazawa	kanazăa
tosa	toá
owi	ơi
khurasan	khuấn
ansar	ánar
thorazine	thoaine
misr	mỉ
tono	tôn
vwf	vừ
cwc	cưc
afi	ài
chars	chá
risperidone	ríperidone
lusk	lúk
eet	êt
leet	lêt
rix	rĩ
lowi	lơi
mums	múm
termine	tẻmine
uts	út
sops	sóp
cwm	cưm
ansatz	anat
arawak	ẩk
gyms	gým
tost	tót
herm	hẻm
dess	des
ruses	rué
gaf	gà
rescher	rểch
nescience	nécience
suas	súa
khas	khá
vaso	váo
umw	ưm
nips	níp
curfews	cưès
horas	hoá
harz	ha
guyer	guyẻ
thioridazine	thioidaine
ganja	gận
sws	sứ
sif	sì
yukawa	yukăa
comoros	cổmos
bors	bó
bair	bải
pharos	pháo
tosi	tói
nays	náy
sexe	sễ
goof	gồ
pomo	pôm
sers	sé
meow	meơ
paar	pẩ
tura	tủa
morons	mốn
nono	nôn
boons	bốn
duds	đú
oms	óm
muro	muỏ
pyrimethamine	pyỉmethamine
tif	tì
uas	úa
ders	dé
macaw	măc
nueces	nuếc
hys	hý
doxa	doã
bajaj	bậ
oom	ôm
vix	vĩ
haro	hảo
ests	ét
lujan	luạn
hejaz	hea
lier	liẻ
vips	víp
aai	âi
truax	trũa
oakwood	ơakood
tisch	tích
catriona	cảtiona
ury	uỷ
dooms	dốm
pwd	pưd
marfa	mầ
mier	miẻ
hinshaw	hínhă
itraconazole	itaconaole
majus	máu
basi	bái
cama	câm
dois	dói
oor	ổ
mux	mũ
cof	cò
dorf	dò
horm	hỏm
nwfp	nừp
teem	têm
lwow	lươ
nof	nò
daa	dâ
giese	giế
awk	ăk
chara	chẩ
misa	mía
bursar	bủa
heeft	hềt
ariz	ai
hest	hét
hooch	hôch
risa	ría
coeff	coef
therm	thẻm
aaaa	aaa
apf	àp
varnas	vấn
hormuz	homu
saxo	são
nuys	nuý
capsize	capie
soja	soạ
coef	coè
naya	nây
eer	ể
aspx	ãp
sese	sế
hijra	hỉa
curs	cú
asat	ất
recs	réc
ief	iè
churns	chún
vermes	vếm
khama	khâm
maat	mât
chiefest	chiết
homogenize	homgenie
boff	bof
ajc	ạc
mamas	mấm
tems	tém
mox	mõ
curwen	cưẻn
cedaw	cedă
mansa	mấn
barna	bẩn
laa	lâ
vois	vói
chama	châm
safa	sầ
uris	úi
oon	ôn
imr	ỉm
lais	lái
buret	buẻt
amj	ạm
chainsaw	chainsă
dunfermline	dùnermline
usps	úp
danda	đân
tanah	tânh
taran	tẩn
chora	choả
chur	chủ
roark	roảk
lese	lế
bots	bót
lowa	lơa
larus	láu
nias	nía
meses	mế
puer	puẻ
miyazawa	miyazăa
esm	ém
oost	ốt
hese	hế
nori	nỏi
eor	ẻo
duos	duó
tux	tũ
corsi	cói
gari	gải
nats	nát
oaf	oà
borja	boạ
langs	láng
ofi	òi
hasa	hấ
nux	nũ
bere	bể
corms	cóm
roszak	roak
ansa	ána
loris	lói
rans	rán
curso	cuó
chere	chể
dims	dím
sachar	sẩch
suess	sues
rasta	rất
hiaa	hiâ
kathiawar	kathiăar
thur	thủ
pongo	pông
daran	dẩn
maran	mẩn
lir	lỉ
vana	vân
trias	tría
trost	trót
hacksaw	hacksă
cari	cải
borst	bót
daraus	dấu
usus	úu
usca	úca
durr	dur
etf	èt
aspasia	ápasia
duree	duể
sauf	sàu
musi	múi
sansovino	sánovino
macha	mâch
efs	é
kes	ké
saur	sảu
towson	tốn
boj	bọ
teems	tếm
gir	gỉ
haf	hà
lesch	léch
thaf	thà
etr	ẻt
khor	khỏ
cays	cáy
raaf	rầ
mest	mét
garn	gản
carmona	cảmona
theos	théo
basch	bách
iprs	íp
sacha	sâch
kagawa	kagăa
heere	hểe
dermatome	dẻmatome
masi	mái
eres	ế
gierek	giểk
nusa	núa
mwd	mưd
cowpox	cơpox
chos	chó
techs	téch
dej	dẹ
borno	bổn
mackinaw	mackină
iasc	iác
hoon	hôn
kins	kín
kertesz	kêt
vias	vía
saro	sảo
moana	moân
quires	quiẻs
quar	quả
pana	pân
ddi	đi
sori	sỏi
gara	gẩ
pene	pên
kerns	kén
nisa	nía
nwp	nưp
maro	mảo
booz	bo
morais	moái
inra	ỉna
raa	râ
awn	ăn
hcm	Hồ Chí Minh
gujrat	guảt
kiran	kiản
nits	nít
tras	trá
soas	soá
espinoza	epinoa
sanga	sâng
euer	ểu
hooft	hồt
khana	khân
eets	ết
masc	mác
chor	chỏ
burs	bú
irst	ít
ifrs	í
chari	chải
poof	pồ
efe	ề
dard	đả
itf	ìt
gaor	gảo
ofs	ó
taff	taf
transdisciplinary	trándisciplinary
tari	tải
berns	bén
usi	úi
oaa	oâ
nishikawa	nishikăa
mene	mên
uart	uảt
vif	vì
gams	gám
camas	cấm
thaws	thắ
mojo	mộ
duas	dúa
qur	qủ
mees	mế
uscs	úc
haart	hẩt
afsc	ác
musca	múca
buri	bủi
birr	bir
demes	dếm
miers	mié
mure	muẻ
bori	bỏi
demsetz	dêmt
esos	éo
costo	cốt
turan	tuản
buprenorphine	bủpenorphine
usk	úk
saif	sài
siraj	sịa
baro	bảo
rieff	rief
erez	ê
hasp	háp
nws	nứ
owa	ơa
dusan	duán
viana	viân
anga	âng
dono	dôn
menezes	mến
beste	bết
dacs	dác
caus	cáu
eero	ểo
dufay	duày
sef	sè
gawk	găk
dethrone	dẻthone
dered	để
ches	ché
terza	tea
unfazed	unaed
charis	chái
herne	hển
vais	vái
tury	tuỷ
cajamarca	cậmarca
irf	ì
rusch	rúch
cooch	côch
coj	cọ
gits	gít
thuja	thụa
bwv	bưv
gies	gié
causas	cấu
duer	duẻ
usis	úi
nanga	nâng
surprize	supie
osf	ò
ofr	ỏ
taxus	táu
luso	luó
yere	yể
sora	soả
coreldraw	coreldră
dimethylformamide	đimethylformamie
lianas	liấn
transf	tràn
yx	ỹ
coleslaw	coleslă
musts	mút
ufw	ừ
diddle	đidle
lamaze	lame
qwl	qưl
ress	res
uji	ụi
riss	ris
gierke	giẻke
sasa	sấ
nars	ná
garay	gẩy
mongo	mông
conj	cọn
soest	soét
pauw	paư
chowk	chơk
marwan	mẩn
ojt	ọt
sofer	soẻ
suraj	sụa
ganj	gạn
chamar	chẩm
baji	bại
lairs	lái
lary	lảy
lipschitz	lipchit
lwr	lử
mischa	mícha
rias	ría
tums	túm
coif	còi
seps	sép
homs	hóm
safi	sài
looses	lôés
khoo	khô
lesen	lến
nere	nể
anj	ạn
masculinized	maculinied
howson	hốn
peche	pêch
paca	pâc
bowra	bởa
gorst	gót
doms	dóm
ajnr	ản
homozygote	homygote
chosa	choá
soochow	sôchow
kisch	kích
ajay	ậy
sarna	sẩn
harar	hẩ
larix	lãi
etfs	ét
daddies	đadies
kyr	kỷ
canr	cản
thier	thiẻ
leszek	lêk
dusen	duén
benj	bẹn
mufioz	muio
dojo	dộ
aras	ấ
usna	úna
noss	nos
marsyas	mấy
asan	ấn
naja	nậ
sems	sém
cofer	coẻ
lene	lên
dese	dế
huis	húi
thys	thý
tuns	tún
bienes	biến
maji	mại
gori	gỏi
daan	dân
pwn	pưn
sero	sẻo
mef	mè
doerr	doer
teepee	têpee
laf	là
nari	nải
guis	gúi
hern	hẻn
sechs	séch
mayaguez	maygue
pois	pói
dern	dẻn
quist	quít
roon	rôn
oems	oém
leese	lếe
hija	hịa
otr	ỏt
hermine	hẻmine
phasors	pháo
aor	ảo
tiran	tiản
unspecialized	unpecialied
nier	niẻ
chana	chân
marz	ma
naif	nài
macaws	mắc
minx	mĩn
hojo	hộ
roff	rof
oer	oẻ
langa	lâng
enfer	èner
hongo	hông
dox	dõ
dosi	dói
gorz	go
nachr	nảch
dudek	đuek
nees	nế
usaaf	uầ
kier	kiẻ
sugawara	sugăara
unf	ùn
demers	dếm
maur	mảu
basa	bấ
powis	pới
mero	mẻo
rauf	ràu
mys	mý
coms	cóm
somos	sốm
lipsitz	lipit
osp	óp
asps	áp
daru	dảu
vins	vín
aji	ại
biran	biản
aua	âu
coots	cốt
quickdraw	quickdră
boleslaw	boleslă
rur	rủ
thorez	thoe
dosa	doá
vose	voé
lins	lín
rej	rẹ
vues	vué
ipf	ìp
baratz	bât
lecher	lểch
bursary	buảy
torno	tổn
casta	cất
hots	hót
coss	cos
vansina	vánina
thej	thẹ
momo	môm
pricewaterhousecoopers	ppricewaterhousecoopers
goro	gổ
nwc	nưc
teos	téo
locos	lốc
ays	áy
romo	rôm
lown	lơn
otf	òt
isf	ì
daws	dắ
bama	bâm
esk	ék
busk	búk
bwr	bử
casu	cáu
laus	láu
botox	bỗt
basor	bảo
vasu	váu
thasos	tháo
borns	bón
usfs	ú
zw	zư
husak	huák
thefe	thề
doron	dổn
orizaba	oiaba
roop	rôp
quanah	quânh
panas	pấn
leos	léo
mij	mị
veroff	veof
neere	nểe
tef	tè
corm	cỏm
defmed	đềm
phips	phíp
suso	suó
chamars	chấm
oooooo	oooo
denr	dẻn
hif	hì
huw	hư
bex	bẽ
muri	mủi
bost	bót
heuer	hểu
pooch	pôch
tiss	tis
gyr	gỷ
usf	ù
phono	phôn
nasca	nấc
thair	thải
rues	rué
coso	cố
ofm	òm
viens	vién
gwr	gử
hamar	hẩm
nwt	nưt
rosi	rói
dury	duỷ
anr	ản
coosa	cốa
utf	ùt
morss	mos
losch	lóch
rexx	rex
tiefe	tiề
xanax	xẫn
afo	ào