a-đrê-na-lin	a-ddree-na-lin	a-đrê-na-lin	a-đree-na-lin
a-pác-thai	a-pac-thais	a-pác-thai	a-pac-thái
a-tlát	a-tlats	a-tlát	a-tlats
a-tÒrô-pin	a-tOroo-pinf	a-tÒrô-pin	a-tOo-pìn
a-tua-đờ-rôn	a-tua-ddow-roonf	a-tua-đờ-rôn	a-tua-đơ-rồn
a-zốt	a-zoots	a-zốt	a-zoots
ác-bít	ac-bits	ác-bít	ac-bít
ác-coóc	ac-coocs	ác-coóc	ac-cốc
ác-coóc-đê-ông	ac-cooc-ddee-oongs	ác-coóc-đê-ông	ac-côc-đê-ống
ác-mô-ni-ca	ac-moo-ni-cas	ác-mô-ni-ca	ac-mô-ni-cá
ác-quy	ac-quys	ác-quy	ac-quý
ác-ten	ac-tens	ác-ten	ac-tén
ác-ti-sô	ac-ti-soos	ác-ti-sô	ac-ti-số
acre	acre	acre	ảce
afghani	afghani	afghani	àghani
alô	aloo	alô	aloo
amatơ	amatow	amatơ	amatow
an-tÒra-xít	an-tOra-xits	an-tÒra-xít	an-tOả-xít
anh-te-ruýp-tơ	anh-te-ruyp-tows	anh-te-ruýp-tơ	anh-te-ruyp-tớ
áp-ga-ni	ap-ga-nis	áp-ga-ni	ap-ga-ní
áp-phe	ap-phes	áp-phe	ap-phé
áp-phích	ap-phichs	áp-phích	ap-phích
áp-xe	ap-xes	áp-xe	ap-xé
apxe	apxe	apxe	ãpe
Ar	Ar	Ar	Ả
armonica	armonica	armonica	ảmonica
arsenic	arsenic	arsenic	aénic
As	As	As	Á
ASEAN	ASEAN	ASEAN	AÉAN
asen	asen	asen	aén
asphalt	asphalt	asphalt	áphalt
aspirin	aspirin	aspirin	ápirin
át-lát	at-lats	át-lát	at-lát
át-mốt-phe	at-moot-phes	át-mốt-phe	at-môt-phé
át-phan	at-phans	át-phan	at-phán
át-pi-rin	at-pi-rins	át-pi-rin	at-pi-rín
át-xít	at-xits	át-xít	at-xít
atropin	atropin	atropin	ảtopin
axetilen	axetilen	axetilen	aẽtilen
axeton	axeton	axeton	aẽton
axit	axit	axit	aĩt
ắc-coóc	awc-coocs	ắc-coóc	ăc-cốc
ắc-coóc-đê-ông	awc-cooc-ddee-oongs	ắc-coóc-đê-ông	ăc-côc-đê-ống
ắc-ê	awc-ees	ắc-ê	ăc-ế
ắc-qui	awc-quis	ắc-qui	ăc-quí
ắc-quy	awc-quys	ắc-quy	ăc-quý
ắc-xi-đăng	awc-xi-ddawngs	ắc-xi-đăng	ăc-xi-đắng
ăccoóc	awccoocs	ăccoóc	ăccoocs
ăccoócđêông	awccoocddeeoongs	ăccoócđêông	ăccoocđeeoongs
ăm-bờ-ra-da	awm-bow-ra-daf	ăm-bờ-ra-da	ăm-bơ-ra-dà
ba-đờ-xuy	ba-ddow-xuyf	ba-đờ-xuy	ba-đơ-xuỳ
ba-zơ	ba-zow	ba-zơ	ba-zow
bà-la-môn	ba-la-moonf	bà-la-môn	ba-la-mồn
badôca	badooca	badôca	badooca
balê	balee	balê	balee
balô	baloo	balô	baloo
balông	baloong	balông	baloong
bancông	bancoong	bancông	bancoong
bành-tô	banh-toof	bành-tô	banh-tồ
banjo	banjo	banjo	bạno
bar	bar	bar	bả
barem	barem	barem	baẻm
baren	baren	baren	baẻn
barie	barie	barie	baỉe
barrel	barrel	barrel	barel
basalt	basalt	basalt	bấlt
base	base	base	baé
BASIC	BASIC	BASIC	BAÍC
basoi	basoi	basoi	baói
bát-két	bat-kets	bát-két	bat-két
bát-kết	bat-keets	bát-kết	bat-kết
batê	batee	batê	batee
batinê	batinee	batinê	batinee
batrui	batrui	batrui	bảtui
bazơ	bazow	bazơ	bazow
bắt-tê	bawt-tees	bắt-tê	băt-tế
béc-giê	bec-giees	béc-giê	bec-giế
becgiê	becgiee	becgiê	becgiee
bêrê	beeree	bêrê	bểee
bêtông	beetoong	bêtông	bêtoong
Bhallê	Bhallee	Bhallê	Bhallee
bích-cốt	bich-coots	bích-cốt	bich-cốt
bích-qui	bich-quis	bích-qui	bich-quí
bích-quy	bich-quys	bích-quy	bich-quý
bichcôt	bichcoot	bichcôt	bichcoot
biđông	biddoong	biđông	biđoong
bíp-tết	bip-teets	bíp-tết	bip-tết
biptêt	bipteet	biptêt	bipteet
birr	birr	birr	bir
bis	bis	bis	bí
bismut	bismut	bismut	bímut
bít-cốt	bit-coots	bít-cốt	bit-cốt
bít-mút	bit-muts	bít-mút	bit-mút
bít-quy	bit-quys	bít-quy	bit-quý
bít-tết	bit-teets	bít-tết	bit-tết
bít-tông	bit-toongs	bít-tông	bit-tống
bitcôt	bitcoot	bitcôt	bitcoot
Blô	Bloo	Blô	Bloo
blốc	bloocs	blốc	bloocs
bombê	bombee	bombê	bombee
bonsevich	bonsevich	bonsevich	bónevich
boóc-đô	booc-ddoos	boóc-đô	bôc-đố
boóc-tê	booc-tees	boóc-tê	bôc-tế
boóng	boongs	boóng	bống
box	box	box	bõ
bồ-tạt	boo-tatj	bồ-tạt	bô-tạt
bốc-can	booc-cans	bốc-can	bôc-cán
bốc-xít	booc-xits	bốc-xít	bôc-xít
bốc-xơ	booc-xows	bốc-xơ	bôc-xớ
bôđê	booddee	bôđê	bôđee
bônsêvich	boonseevich	bônsêvich	bốneevich
bốt-can	boot-cans	bốt-can	bôt-cán
bốt-sét	boot-sets	bốt-sét	bôt-sét
bốt-tin	boot-tins	bốt-tin	bôt-tín
bờ-lăng-tông	bow-lawng-toongf	bờ-lăng-tông	bơ-lăng-tồng
bờ-lu	bow-luf	bờ-lu	bơ-lù
bờ-lu-dông	bow-lu-doongf	bờ-lu-dông	bơ-lu-dồng
bờ-rát-xa	bow-rat-xas	bờ-rát-xa	bơ-rat-xá
Brâu	Braau	Brâu	Braau
brôm	broom	brôm	broom
bù-ét	bu-ets	bù-ét	bu-ét
buji	buji	buji	bụi
bulông	buloong	bulông	buloong
búp-bê	bup-bees	búp-bê	bup-bế
búp-phê	bup-phees	búp-phê	bup-phế
bupbê	bupbee	bupbê	bupbee
bupphê	bupphee	bupphê	bupphee
buýp-phê	buyp-phees	buýp-phê	buyp-phế
cà-mèn	ca-menf	cà-mèn	ca-mèn
cà-phê	ca-pheef	cà-phê	ca-phề
cà-phê	ca-pheef	cà-phê	ca-phề
cà-rem	ca-remf	cà-rem	ca-rèm
cà-ri	ca-rif	cà-ri	ca-rì
cà-rốt	ca-roots	cà-rốt	ca-rốt
cà-rốt	ca-roots	cà-rốt	ca-rốt
cà-vạt	ca-vatj	cà-vạt	ca-vạt
các-bin	cac-bins	các-bin	cac-bín
các-bo-nát	cac-bo-nats	các-bo-nát	cac-bo-nát
các-bon	cac-bons	các-bon	cac-bón
các-bon-nát	cac-bon-nats	các-bon-nát	cac-bon-nát
các-bon-ních	cac-bon-nichs	các-bon-ních	cac-bon-ních
các-bua	cac-buas	các-bua	cac-búa
các-táp	cac-taps	các-táp	cac-táp
các-ten	cac-tens	các-ten	cac-tén
các-tông	cac-toongs	các-tông	cac-tống
các-tơ	cac-tows	các-tơ	cac-tớ
các-vi-dít	cac-vi-dits	các-vi-dít	cac-vi-dít
các-xtơ	cac-xtows	các-xtơ	cac-xtows
cactông	cactoong	cactông	cactoong
cafein	cafein	cafein	caèin
cafê	cafee	cafê	caèe
calô	caloo	calô	caloo
camnhông	camnhoong	camnhông	camnhoong
canô	canoo	canô	canoo
canông	canoong	canông	canoong
canxi	canxi	canxi	cãni
caosu	caosu	caosu	caóu
cara	cara	cara	cẩ
carate	carate	carate	cẩte
carbin	carbin	carbin	cảbin
carbon	carbon	carbon	cảbon
carbonat	carbonat	carbonat	cảbonat
carbur	carbur	carbur	cảbur
cari	cari	cari	cải
carô	caroo	carô	caổ
cartel	cartel	cartel	cảtel
casino	casino	casino	caíno
casset	casset	casset	caset
cát-két	cat-kets	cát-két	cat-két
cát-mi	cat-mis	cát-mi	cat-mí
cát-sê	cat-sees	cát-sê	cat-sế
cát-xét	cat-xets	cát-xét	cat-xét
catalô	cataloo	catalô	cataloo
catôt	catoot	catôt	catoot
catsê	catsee	catsê	cátee
catxet	catxet	catxet	cãtet
cắc-tê	cawc-tees	cắc-tê	căc-tế
Chí-phèo	Chi-pheof	Chí-phèo	Chi-phèo
choòng	choongf	choòng	chồng
chưởì	chuwowif	chưởì	chười
clê-a-rin	clee-a-rin	clê-a-rin	clee-a-rin
cò-mi	co-mif	cò-mi	co-mì
cỏ-vê	co-veer	cỏ-vê	co-vể
com-bờ-lê	com-bow-leef	com-bờ-lê	com-bơ-lề
com-mít-xi-ông	com-mit-xi-oongs	com-mít-xi-ông	com-mit-xi-ống
com-plê	com-plee	com-plê	com-plee
còm-mi	com-mif	còm-mi	com-mì
comlê	comlee	comlê	comlee
commăng	commawng	commăng	commawng
commăng-ca	commawng-ca	commăng-ca	commawng-ca
con-léc-xi-ông	con-lec-xi-oongs	con-léc-xi-ông	con-lec-xi-ống
confetti	confetti	confetti	cònetti
cong-tờ-gút	cong-tow-guts	cong-tờ-gút	cong-tơ-gút
consol	consol	consol	cónol
consortium	consortium	consortium	cónortium
conxecto	conxecto	conxecto	cõnecto
coóc-nê	cooc-nees	coóc-nê	côc-nế
coóc-ti-don	cooc-ti-dons	coóc-ti-don	côc-ti-dón
coóc-ti-dôn	cooc-ti-doons	coóc-ti-dôn	côc-ti-dốn
coóc-xê	cooc-xees	coóc-xê	côc-xế
cọp-dê	cop-deej	cọp-dê	cop-dệ
copfa	copfa	copfa	còpa
Cor	Cor	Cor	Cỏ
cordoba	cordoba	cordoba	cỏdoba
cortison	cortison	cortison	cỏtison
cos	cos	cos	có
cosin	cosin	cosin	coín
cổ-dề	coo-deef	cổ-dề	cô-dề
cốc-tai	cooc-tais	cốc-tai	côc-tái
cốc-tay	cooc-tays	cốc-tay	côc-táy
công-phét-ti	coong-phet-tis	công-phét-ti	công-phet-tí
công-xéc-tô	coong-xec-toos	công-xéc-tô	công-xec-tố
công-xoóc-xi-om	coong-xooc-xi-oms	công-xoóc-xi-om	công-xôc-xi-óm
côngtắc	coongtawcs	côngtắc	côngtawcs
côngtenơ	coongtenow	côngtenơ	côngtenow
côngtơ	coongtow	côngtơ	côngtow
côngxectô	coongxectoo	côngxectô	cỗngectoo
côngxon	coongxon	côngxon	cỗngon
cốp-pha	coop-phas	cốp-pha	côp-phá
côsin	coosin	côsin	côín
cốt-lét	coot-lets	cốt-lét	côt-lét
cốt-nhát	coot-nhats	cốt-nhát	côt-nhát
cốt-nhắc	coot-nhawcs	cốt-nhắc	côt-nhắc
cốt-pha	coot-phas	cốt-pha	côt-phá
cốt-phát	coot-phats	cốt-phát	côt-phát
côtông	cootoong	côtông	côtoong
cờ-lê	cow-leef	cờ-lê	cơ-lề
cờ-lếp	cow-leeps	cờ-lếp	cơ-lếp
cờ-ra-vát	cow-ra-vats	cờ-ra-vát	cơ-ra-vát
cờ-rếp	cow-reeps	cờ-rếp	cơ-rếp
cơlê	cowlee	cơlê	cơlee
crêp	creep	crêp	creep
crếp	creeps	crếp	creeps
crô-mít	croo-mits	crô-mít	croo-mít
crôm	croom	crôm	croom
cuaroa	cuaroa	cuaroa	cuaỏa
cuarơ	cuarow	cuarơ	cưảo
cùi-dìa	cui-diaf	cùi-dìa	cui-dìa
culông	culoong	culông	culoong
Cur	Cur	Cur	Củ
curoa	curoa	curoa	cuỏa
cút-lít	cut-lits	cút-lít	cut-lít
derô	deroo	derô	deổ
dêrô	deeroo	dêrô	dêổ
dicdăc	dicdawc	dicdăc	dicdawc
dích-dắc	dich-dawcs	dích-dắc	dich-dắc
dích-lơ	dich-lows	dích-lơ	dich-lớ
diesel	diesel	diesel	diếl
dirham	dirham	dirham	dỉham
dura	dura	dura	dủa
duralumin	duralumin	duralumin	duảlumin
Đại-dương-châu	Ddai-duwowng-chaauj	Đại-dương-châu	Đai-dương-chậu
đét-xe	ddet-xes	đét-xe	đet-xé
đexi-	ddexi-	đexi-	đeĩ-
đexiben	ddexiben	đexiben	đeĩben
đề-bô	ddee-boof	đề-bô	đê-bồ
đề-ca	ddee-caf	đề-ca	đê-cà
đề-can	ddee-canf	đề-can	đê-càn
đề-ma-rơ	ddee-ma-rowf	đề-ma-rơ	đê-ma-rờ
đề-mác	ddee-macs	đề-mác	đê-mác
đề-mốt-đê	ddee-moot-ddees	đề-mốt-đê	đê-môt-đế
đề-pa	ddee-paf	đề-pa	đê-pà
đề-pô	ddee-poof	đề-pô	đê-pồ
đề-sạc	ddee-sacj	đề-sạc	đê-sạc
đề-xi-ben	ddee-xi-benf	đề-xi-ben	đê-xi-bèn
đề-xi-la	ddee-xi-laf	đề-xi-la	đê-xi-là
đề-xi-mét	ddee-xi-mets	đề-xi-mét	đê-xi-mét
đíp-lôm	ddip-looms	đíp-lôm	đip-lốm
đít-cua	ddit-cuas	đít-cua	đit-cúa
đivăng	ddivawng	đivăng	đivawng
đốc-tờ	ddooc-towf	đốc-tờ	đôc-tờ
đôminô	ddoominoo	đôminô	đôminoo
đốt-xi-ê	ddoot-xi-ees	đốt-xi-ê	đôt-xi-ế
đờ-măng	ddow-mawngf	đờ-măng	đơ-mằng
đờ-mi	ddow-mif	đờ-mi	đơ-mì
đờ-o	ddow-of	đờ-o	đơ-ò
đúp-lê	ddup-lees	đúp-lê	đup-lế
đura	ddura	đura	đủa
đuyra	dduyra	đuyra	đuỷa
e-léc-tron	e-lec-trons	e-léc-tron	e-lec-trón
ép-phê	ep-phees	ép-phê	ep-phế
ép-xi-lon	ep-xi-lons	ép-xi-lon	ep-xi-lón
epsilon	epsilon	epsilon	épilon
escudo	escudo	escudo	écudo
esperanto	esperanto	esperanto	éperanto
este	este	este	éte
ét-coóc	et-coocs	ét-coóc	et-cốc
ét-xăng	et-xawngs	ét-xăng	et-xắng
ét-xe	et-xes	ét-xe	et-xé
ét-xpê-răn-tô	et-xpee-rawn-toos	ét-xpê-răn-tô	et-xpee-răn-tố
ét-xte	et-xtes	ét-xte	et-xtes
etxăng	etxawng	etxăng	ẽtawng
ê-léc-tÒron	ee-lec-tOronf	ê-léc-tÒron	ê-lec-tỒn
ê-léc-tron	ee-lec-trons	ê-léc-tron	ê-lec-trón
ê-lếch-tơ-rôn	ee-leech-tow-roons	ê-lếch-tơ-rôn	ê-lêch-tơ-rốn
ê-spê-ran-tô	ee-spee-ran-too	ê-spê-ran-tô	ê-spee-ran-tô
êđê-êga	eeddee-eega	êđê-êga	êđee-êga
êtô	eetoo	êtô	êtoo
féc-mơ-tuya	fec-mow-tuyas	féc-mơ-tuya	fec-mơ-tuýa
fi-brô-xi-măng	fi-broo-xi-mawng	fi-brô-xi-măng	fi-broo-xi-măng
fibroximăng	fibroximawng	fibroximăng	fibroximawng
fizê	fizee	fizê	fizee
foóc-môn	fooc-moons	foóc-môn	fooc-mốn
foóc-xép	fooc-xeps	foóc-xép	fooc-xép
frăng	frawng	frăng	frawng
fuốc-sét	fuooc-sets	fuốc-sét	fuooc-sét
ga-bác-đin	ga-bac-ddins	ga-bác-đin	ga-bac-đín
ga-zô-lin	ga-zoo-lin	ga-zô-lin	ga-zoo-lin
gà-mèn	ga-menf	gà-mèn	ga-mèn
gác-dan	gac-dans	gác-dan	gac-dán
gác-dang	gac-dangs	gác-dang	gac-dáng
gác-đa-vu	gac-dda-vus	gác-đa-vu	gac-đa-vú
gác-đê-nan	gac-ddee-nans	gác-đê-nan	gac-đê-nán
gác-điêng	gac-ddieengs	gác-điêng	gac-điếng
gác-đờ-bu	gac-ddow-buf	gác-đờ-bu	gac-đơ-bù
gác-đờ-co	gac-ddow-cof	gác-đờ-co	gac-đơ-cò
gác-đờ-sen	gac-ddow-senf	gác-đờ-sen	gac-đơ-sèn
gác-măng-dê	gac-mawng-dees	gác-măng-dê	gac-măng-dế
gác-xon-nê	gac-xon-nees	gác-xon-nê	gac-xon-nế
gacđiêng	gacddieeng	gacđiêng	gacđieeng
galăng	galawng	galăng	galawng
gangster	gangster	gangster	gángter
Gar	Gar	Gar	Gả
gara	gara	gara	gẩ
garô	garoo	garô	gaổ
gas	gas	gas	gá
gatô	gatoo	gatô	gatoo
găng-xtơ	gawng-xtow	găng-xtơ	găng-xtow
găngxtơ	gawngxtow	găngxtơ	gẵngtow
germanium	germanium	germanium	gẻmanium
ghiđông	ghiddoong	ghiđông	ghiđoong
giămbông	giawmboong	giămbông	giămboong
Giẻ-triêng	Gie-trieengr	Giẻ-triêng	Gie-triểng
gilê	gilee	gilê	gilee
glô-côm	gloo-coom	glô-côm	gloo-côm
glôcôm	gloocoom	glôcôm	gloocoom
goòng	goongf	goòng	gồng
gorilla	gorilla	gorilla	goỉlla
gourde	gourde	gourde	goủde
gôrila	goorila	gôrila	gôỉla
Gơ-lar	Gow-lar	Gơ-lar	Gơ-lả
gờ-ram	gow-ramf	gờ-ram	gơ-ràm
gơn-đờ-lu	gown-ddow-luf	gơn-đờ-lu	gơn-đơ-lù
grát	grats	grát	grats
gu-đrông	gu-ddroong	gu-đrông	gu-đroong
guarani	guarani	guarani	guẩni
Hà-lăng	Ha-lawngf	Hà-lăng	Ha-lằng
hác-pơ	hac-pows	hác-pơ	hac-pớ
háp-trắc	hap-trawcs	háp-trắc	hap-trắc
harmonica	harmonica	harmonica	hảmonica
he-mô-glô-bin	he-moo-gloo-bin	he-mô-glô-bin	he-mô-gloo-bin
héc-ta	hec-tas	héc-ta	hec-tá
héc-to	hec-tos	héc-to	hec-tó
héc-tô-gam	hec-too-gams	héc-tô-gam	hec-tô-gám
héc-tô-lít	hec-too-lits	héc-tô-lít	hec-tô-lít
héc-tô-mét	hec-too-mets	héc-tô-mét	hec-tô-mét
heroin	heroin	heroin	heỏin
hertz	hertz	hertz	het
hê-mô-glô-bin	hee-moo-gloo-bin	hê-mô-glô-bin	hê-mô-gloo-bin
hi-đrát	hi-ddrats	hi-đrát	hi-đrats
hi-đrô	hi-ddroo	hi-đrô	hi-đroo
hi-đrô-các-bon	hi-ddroo-cac-bons	hi-đrô-các-bon	hi-đroo-cac-bón
hi-đrô-clo-rua	hi-ddroo-clo-rua	hi-đrô-clo-rua	hi-đroo-clo-rua
hi-đrô-xít	hi-ddroo-xits	hi-đrô-xít	hi-đroo-xít
híp-pi	hip-pis	híp-pi	hip-pí
hoóc-mon	hooc-mons	hoóc-mon	hôc-món
hoóc-môn	hooc-moons	hoóc-môn	hôc-mốn
hormon	hormon	hormon	hỏmon
Hrê	Hree	Hrê	Hree
hu-blông	hu-bloong	hu-blông	hu-bloong
hừ!	huw!f	hừ!	hhừ
hứ!	huw!s	hứ!	hhứ
hy-đrô	hy-ddroo	hy-đrô	hy-đroo
ích-xì	ich-xif	ích-xì	ich-xì
inôc	inooc	inôc	inooc
insulin	insulin	insulin	ínulin
jắc	jawcs	jắc	jawcs
jăm-bông	jawm-boong	jăm-bông	jawm-bông
jíp	jips	jíp	jips
káp-pa	kap-pas	káp-pa	kap-pá
két-xông	ket-xoongs	két-xông	ket-xống
Khù-sung	Khu-sungf	Khù-sung	Khu-sùng
khuýp	khuyps	khuýp	khuyps
khuỷu	khuyur	khuỷu	khuyur
khuỵu	khuyuj	khuỵu	khuyuj
kí-lô	ki-loos	kí-lô	ki-lố
kí-ninh	ki-ninhs	kí-ninh	ki-nính
kilô	kiloo	kilô	kiloo
kíp-lê	kip-lees	kíp-lê	kip-lế
Kốc	Koocs	Kốc	Koocs
Kpă	Kpaw	Kpă	Kpaw
Kpăng-công	Kpawng-coong	Kpăng-công	Kpawng-công
Ktlê	Ktlee	Ktlê	Ktlee
Kuênh	Kueenh	Kuênh	Kueenh
Kủo	Kuor	Kủo	Kuor
kuýp	kuyps	kuýp	kuyps
kW	kW	kW	kƯ
kw	kw	kw	kư
kW-h	kW-h	kW-h	kƯ-h
kwacha	kwacha	kwacha	kưacha
kwanza	kwanza	kwanza	kuana
ký-ninh	ky-ninhs	ký-ninh	ky-nính
la-coóc	la-coocs	la-coóc	la-cốc
lạc-dang	lac-dangj	lạc-dang	lac-dạng
ladơn	ladown	ladơn	ladown
lanhtô	lanhtoo	lanhtô	lanhtoo
lari	lari	lari	lải
laser	laser	laser	laér
lát-ti	lat-tis	lát-ti	lat-tí
lát-xê	lat-xees	lát-xê	lat-xế
lavabô	lavaboo	lavabô	lavaboo
layơn	layown	layơn	layown
lắc-lê	lawc-lees	lắc-lê	lăc-lế
lăclê	lawclee	lăclê	lăclee
lập-bô	laap-booj	lập-bô	lâp-bộ
lập-gioòng	laap-gioongf	lập-gioòng	lâp-giồng
lập-lắc	laap-lawcs	lập-lắc	lâp-lắc
lập-lòn	laap-lonf	lập-lòn	lâp-lòn
lập-loòng	laap-loongf	lập-loòng	lâp-lồng
lèõ	leox	lèõ	lẽo
li-vrê	li-vree	li-vrê	li-vree
lintô	lintoo	lintô	lintoo
líp-phăng-xe	lip-phawng-xes	líp-phăng-xe	lip-phăng-xé
lira	lira	lira	lỉa
lít-xăng	lit-xawngs	lít-xăng	lit-xắng
lít-xê	lit-xees	lít-xê	lit-xế
litô	litoo	litô	litoo
lò-xo	lo-xof	lò-xo	lo-xò
lốc-kê	looc-kees	lốc-kê	lôc-kế
lốc-nốt	looc-noots	lốc-nốt	lôc-nốt
lôcôt	loocoot	lôcôt	lôcoot
ma-cà-bông	ma-ca-boongf	ma-cà-bông	ma-ca-bồng
ma-cà-rồng	ma-ca-roongf	ma-cà-rồng	ma-ca-rồng
ma-két-tinh	ma-ket-tinhs	ma-két-tinh	ma-ket-tính
ma-kết-tinh	ma-keet-tinhs	ma-kết-tinh	ma-kêt-tính
mác-ca	mac-cas	mác-ca	mac-cá
mác-ke-tinh	mac-ke-tinhs	mác-ke-tinh	mac-ke-tính
mác-két-tinh	mac-ket-tinhs	mác-két-tinh	mac-ket-tính
mác-kết-tinh	mac-keet-tinhs	mác-kết-tinh	mac-kêt-tính
mác-ma	mac-mas	mác-ma	mac-má
mác-xít	mac-xits	mác-xít	mac-xít
mạc-cờ-rô	mac-cow-roof	mạc-cờ-rô	mac-cơ-rồ
mạc-ga-rít	mac-ga-rits	mạc-ga-rít	mac-ga-rít
mạch-lô	mach-looj	mạch-lô	mach-lộ
macô	macoo	macô	macoo
macro	macro	macro	mảco
macxit	macxit	macxit	mãcit
mafia	mafia	mafia	maìa
manơcanh	manowcanh	manơcanh	manowcanh
marathon	marathon	marathon	mẩthon
mark	mark	mark	mảk
marketing	marketing	marketing	mảketing
markka	markka	markka	mảkka
marxit	marxit	marxit	maĩt
maser	maser	maser	maér
massage	massage	massage	masage
mastic	mastic	mastic	mátic
mát-tít	mat-tits	mát-tít	mat-tít
mát-xa	mat-xas	mát-xa	mat-xá
mạt-chược	mat-chuwowcj	mạt-chược	mat-chược
matxa	matxa	matxa	mãta
mayô	mayoo	mayô	mayoo
mayso	mayso	mayso	maýo
mắc-coọc	mawc-coocj	mắc-coọc	măc-cộc
măngđôlin	mawngddoolin	măngđôlin	măngđoolin
măngsông	mawngsoong	măngsông	mắngoong
măngtô	mawngtoo	măngtô	măngtoo
méc-xì	mec-xif	méc-xì	mec-xì
meson	meson	meson	meón
mét-tinh	met-tinhs	mét-tinh	met-tính
mét-tra	met-tras	mét-tra	met-trá
mét-xì	met-xif	mét-xì	met-xì
mét-xì-a-văng	met-xi-a-vawngf	mét-xì-a-văng	met-xi-a-vằng
mê-tờ-rô	mee-tow-roof	mê-tờ-rô	mê-tơ-rồ
mề-đay	mee-ddayf	mề-đay	mê-đày
mề-đay-dông	mee-dday-doongf	mề-đay-dông	mê-đay-dồng
mền-đay	meen-ddayf	mền-đay	mên-đày
mi-crô	mi-croo	mi-crô	mi-croo
mi-crô-phích	mi-croo-phichs	mi-crô-phích	mi-croo-phích
mi-crô-phim	mi-croo-phim	mi-crô-phim	mi-croo-phim
mi-crô-xi-ông	mi-croo-xi-oong	mi-crô-xi-ông	mi-croo-xi-ông
mi-crông	mi-croong	mi-crông	mi-croong
micro	micro	micro	mỉco
microcomputer	microcomputer	microcomputer	mỉcocomputer
microfich	microfich	microfich	mỉcofich
microfilm	microfilm	microfilm	mỉcofilm
micron	micron	micron	mỉcon
micrô	microo	micrô	mỉcoo
miền-đay	mieen-ddayf	miền-đay	miên-đày
minơ	minow	minơ	minow
mít-tinh	mit-tinhs	mít-tinh	mit-tính
mỏ-lết	mo-leets	mỏ-lết	mo-lết
moóc	moocs	moóc	mốc
moóc-chê	mooc-chees	moóc-chê	môc-chế
moóc-chi-ê	mooc-chi-ees	moóc-chi-ê	môc-chi-ế
moóc-phin	mooc-phins	moóc-phin	môc-phín
morat	morat	morat	moảt
morphin	morphin	morphin	mỏphin
morse	morse	morse	moé
môđéc	mooddecs	môđéc	môđecs
mông-taj	moong-taj	mông-taj	mông-tạ
môngtagiơ	moongtagiow	môngtagiơ	môngtagiow
mộngtriệu	moongtrieeuj	mộngtriệu	môngtrieeuj
môtô	mootoo	môtô	môtoo
môtơ	mootow	môtơ	môtow
mù-soa	mu-soaf	mù-soa	mu-soà
mù-tạt	mu-tatj	mù-tạt	mu-tạt
mùi-soa	mui-soaf	mùi-soa	mui-soà
mùi-xoa	mui-xoaf	mùi-xoa	mui-xoà
mút-cơ-tông	mut-cow-toongs	mút-cơ-tông	mut-cơ-tống
mút-xơ-lin	mut-xow-lins	mút-xơ-lin	mut-xơ-lín
naira	naira	naira	naỉa
náp-ta-len	nap-ta-lens	náp-ta-len	nap-ta-lén
nát-ri	nat-ris	nát-ri	nat-rí
natri	natri	natri	nảti
ngờõ	ngowox	ngờõ	ngỗ
nilông	niloong	nilông	niloong
nitơ	nitow	nitơ	nitow
nitrat	nitrat	nitrat	nỉtat
nitrogen	nitrogen	nitrogen	nỉtogen
niu-cát-xơn	niu-cat-xowns	niu-cát-xơn	niu-cat-xớn
niutơn	niutown	niutơn	niutown
nivô	nivoo	nivô	nivoo
nốc-ao	nooc-aos	nốc-ao	nôc-áo
nốt-xê	noot-xees	nốt-xê	nôt-xế
nơ-tờ-ron	now-tow-ronf	nơ-tờ-ron	nơ-tơ-ròn
nơron	nowron	nơron	nổn
nơtron	nowtron	nơtron	nổtn
NSƯT	NSUwT	NSƯT	NSUwT
oát-kế	oat-kees	oát-kế	oat-kế
õbăng	obawngx	õbăng	obawngx
offset	offset	offset	ofset
oóc	oocs	oóc	ốc
oóc-gan	ooc-gans	oóc-gan	ôc-gán
oóc-giơ	ooc-giows	oóc-giơ	ôc-giớ
opset	opset	opset	ópet
oxi	oxi	oxi	õi
oxid	oxid	oxid	oĩd
oxy	oxy	oxy	oỹ
oxygen	oxygen	oxygen	oỹgen
ô-zôn	oo-zoon	ô-zôn	ô-zoon
ổ-líp	oo-lips	ổ-líp	ô-líp
ôkê	ookee	ôkê	ôkee
ốp-lét	oop-lets	ốp-lét	ôp-lét
ốp-lết	oop-leets	ốp-lết	ôp-lết
ốp-sét	oop-sets	ốp-sét	ôp-sét
ốp-ti-man	oop-ti-mans	ốp-ti-man	ôp-ti-mán
ốp-xét	oop-xets	ốp-xét	ôp-xét
ôpêra	oopeera	ôpêra	ôpeera
ôplêt	oopleet	ôplêt	ôpleet
ôtô	ootoo	ôtô	ôtoo
ôtôbuýt	ootoobuyts	ôtôbuýt	ôtoobuyts
ôtôca	ootooca	ôtôca	ôtooca
ôtômat	ootoomat	ôtômat	ôtoomat
ôtôray	ootooray	ôtôray	ôtooray
ôvăng	oovawng	ôvăng	ôvawng
ơ-ri-xtíc	ow-ri-xtics	ơ-ri-xtíc	ơ-ri-xtics
ơristic	owristic	ơristic	ơític
pa-đờ-xuy	pa-ddow-xuyf	pa-đờ-xuy	pa-đơ-xuỳ
pác-panh	pac-panhs	pác-panh	pac-pánh
pác-séc	pac-secs	pác-séc	pac-séc
palăng	palawng	palăng	palawng
panô	panoo	panô	panoo
parabol	parabol	parabol	pẩbol
paraffin	paraffin	paraffin	pafin
pát-xơ-po	pat-xow-pos	pát-xơ-po	pat-xơ-pó
pát-xten	pat-xtens	pát-xten	pat-xtens
patê	patee	patê	patee
patinê	patinee	patinê	patinee
péc-lông	pec-loongs	péc-lông	pec-lống
péc-măng-ga-nát	pec-mawng-ga-nats	péc-măng-ga-nát	pec-măng-ga-nát
péc-mi	pec-mis	péc-mi	pec-mí
pẹc-xin	pec-xinj	pẹc-xin	pec-xịn
pen-cát-xi-lát	pen-cat-xi-lats	pen-cát-xi-lát	pen-cat-xi-lát
peritxoa	peritxoa	peritxoa	peỉtxoa
peseta	peseta	peseta	pếta
peso	peso	peso	péo
pê-rít-xoa	pee-rit-xoas	pê-rít-xoa	pê-rit-xoá
phạm-nhe	pham-nhej	phạm-nhe	pham-nhẹ
phát-xít	phat-xits	phát-xít	phat-xít
phatxit	phatxit	phatxit	phãtit
phắc-tuya	phawc-tuyas	phắc-tuya	phăc-tuýa
phắc-xi-min	phawc-xi-mins	phắc-xi-min	phăc-xi-mín
phéc-mơ-tuya	phec-mow-tuyas	phéc-mơ-tuya	phec-mơ-tuýa
phẹc-mơ-tuya	phec-mow-tuyaj	phẹc-mơ-tuya	phec-mơ-tuỵa
phidê	phidee	phidê	phidee
phó-mát	pho-mats	phó-mát	pho-mát
phoóc	phoocs	phoóc	phốc
phoóc-môn	phooc-moons	phoóc-môn	phôc-mốn
phoóc-xép	phooc-xeps	phoóc-xép	phôc-xép
phoóc-xếp	phooc-xeeps	phoóc-xếp	phôc-xếp
phosphat	phosphat	phosphat	phóphat
phosphor	phosphor	phosphor	phóphor
phosphorit	phosphorit	phosphorit	phóphorit
phô-tô-cóp-pi	phoo-too-cop-pis	phô-tô-cóp-pi	phô-tô-cop-pí
phốt-phát	phoot-phats	phốt-phát	phôt-phát
phốt-pho	phoot-phos	phốt-pho	phôt-phó
phốt-pho-rít	phoot-pho-rits	phốt-pho-rít	phôt-pho-rít
phôtô	phootoo	phôtô	phôtoo
phờ-răng	phow-rawngf	phờ-răng	phơ-rằng
phrăng	phrawng	phrăng	phrawng
píc-níc	pic-nics	píc-níc	pic-níc
pích-kê	pich-kees	pích-kê	pich-kế
pích-ních	pich-nichs	pích-ních	pich-ních
pijama	pijama	pijama	piạma
pirit	pirit	pirit	piỉt
pít-tông	pit-toongs	pít-tông	pit-tống
plát-ma	plat-mas	plát-ma	plat-má
plát-tích	plat-tichs	plát-tích	plat-tích
plăng	plawng	plăng	plawng
plăng-sê	plawng-see	plăng-sê	plawng-sê
plây	plaay	plây	plaay
positron	positron	positron	poỉton
pờ-rô-gờ-ram	pow-roo-gow-ramf	pờ-rô-gờ-ram	pơ-rô-gơ-ràm
Prâng	Praang	Prâng	Praang
prô-dếch-tơ	proo-deech-tows	prô-dếch-tơ	proo-dêch-tớ
prô-tê-in	proo-tee-in	prô-tê-in	proo-tê-in
prô-tit	proo-tit	prô-tit	proo-tit
prô-tít	proo-tits	prô-tít	proo-tít
prô-ton	proo-ton	prô-ton	proo-ton
prô-tô-côn	proo-too-coon	prô-tô-côn	proo-tô-côn
prô-tôn	proo-toon	prô-tôn	proo-tôn
prô-tông	proo-toong	prô-tông	proo-tông
puốc-boa	puooc-boas	puốc-boa	puôc-boá
puốc-xăng	puooc-xawngs	puốc-xăng	puôc-xắng
pyjama	pyjama	pyjama	pyạma
pyrit	pyrit	pyrit	pyỉt
quart	quart	quart	quảt
quáu	quaus	quáu	quaus
quạu	quauj	quạu	quauj
quều	queeuf	quều	quêuf
quỵp	quypj	quỵp	quypj
quýu	quyus	quýu	quyus
ra-glăng	ra-glawng	ra-glăng	ra-glawng
Ra-glây	Ra-glaay	Ra-glây	Ra-glaay
radio-casset	radio-casset	radio-casset	radio-caset
rađiô	raddioo	rađiô	rađioo
rap<I>	rap<I>	rap<I>	raI>
rát-tê	rat-tees	rát-tê	rat-tế
rắc-co	rawc-cos	rắc-co	răc-có
rê-ốt-xta	ree-oot-xtas	rê-ốt-xta	rê-ôt-xtas
rề-gát	ree-gats	rề-gát	rê-gát
rích-te	rich-tes	rích-te	rich-té
riđô	riddoo	riđô	riđoo
ríp-pê	rip-pees	ríp-pê	rip-pế
rivê	rivee	rivê	rivee
Rlâm	Rlaam	Rlâm	Rlaam
rốc-két	rooc-kets	rốc-két	rôc-két
rốc-kết	rooc-keets	rốc-kết	rôc-kết
rônêô	rooneeoo	rônêô	rôneeoo
rôngđô	roongddoo	rôngđô	rôngđoo
rơ-moóc	row-moocs	rơ-moóc	rơ-mốc
rờ-com-măng-đê	row-com-mawng-ddeef	rờ-com-măng-đê	rơ-com-măng-đề
rờ-moọc	row-moocj	rờ-moọc	rơ-mộc
rờ-sạc	row-sacj	rờ-sạc	rơ-sạc
rờ-séc	row-secs	rờ-séc	rơ-séc
rờ-sét	row-sets	rờ-sét	rơ-sét
rờ-tờ-rét	row-tow-rets	rờ-tờ-rét	rơ-tơ-rét
rờ-tua	row-tuaf	rờ-tua	rơ-tùa
rờ-ve	row-vef	rờ-ve	rơ-vè
rớt-xo	rowt-xos	rớt-xo	rơt-xó
rufiyaa	rufiyaa	rufiyaa	ruiỳaa
rulô	ruloo	rulô	ruloo
ruy-bờ-rích	ruy-bow-richs	ruy-bờ-rích	ruy-bơ-rích
sà-lan	sa-lanf	sà-lan	sa-làn
sà-lúp	sa-lups	sà-lúp	sa-lúp
sác-giơ	sac-giows	sác-giơ	sac-giớ
sặạt	sawatj	sặạt	sật
sẵắn	sawawns	sẵắn	sắn
sắc-xô	sawc-xoos	sắc-xô	săc-xố
sắc-xô-phôn	sawc-xoo-phoons	sắc-xô-phôn	săc-xô-phốn
serenata	serenata	serenata	sểnata
sét-ti	set-tis	sét-ti	set-tí
sex	sex	sex	sẽ
sêếu	seeeeus	sêếu	seeeus
sì-cút	si-cuts	sì-cút	si-cút
sích-ma	sich-mas	sích-ma	sich-má
snách-ba	snach-bas	snách-ba	snach-bá
sóc-cảnh	soc-canhr	sóc-cảnh	soc-cảnh
soóc	soocs	soóc	sốc
soóc-ti	sooc-tis	soóc-ti	sôc-tí
SOS	SOS	SOS	SÓ
sôcôla	soocoola	sôcôla	sôcoola
sốp-phơ	soop-phows	sốp-phơ	sôp-phớ
sôpphơ	soopphow	sôpphơ	sôpphow
SRó	SRos	SRó	SRos
stác-te	stac-tes	stác-te	stac-té
stê-rê-ô	stee-ree-oo	stê-rê-ô	stee-rê-ô
stơ-re-sơ	stow-re-sow	stơ-re-sơ	stow-re-sơ
strích-nin	strich-nins	strích-nin	strich-nín
sú-ba-giăng	su-ba-giawngs	sú-ba-giăng	su-ba-giắng
súc-cù-la	suc-cu-laf	súc-cù-la	suc-cu-là
sucre	sucre	sucre	sủce
sun-fát	sun-fats	sun-fát	sun-fats
sunfamit	sunfamit	sunfamit	sùnamit
sunfat	sunfat	sunfat	sùnat
sunfua	sunfua	sunfua	sùnua
súp-de	sup-des	súp-de	sup-dé
súp-lơ	sup-lows	súp-lơ	sup-lớ
suplơ	suplow	suplơ	suplow
Tà-ôi	Ta-ooif	Tà-ôi	Ta-ồi
tác-tuýp	tac-tuyps	tác-tuýp	tac-tuyps
Tạng-Miến	Tang-Mieens	Tạng-Miến	Tang-Miến
táp-blô	tap-bloos	táp-blô	tap-bloos
táp-lô	tap-loos	táp-lô	tap-lố
tạp-dề	tap-deef	tạp-dề	tap-dề
Tareh	Tareh	Tareh	Taẻh
tarô	taroo	tarô	taổ
tatăng	tatawng	tatăng	tatawng
taxi	taxi	taxi	tãi
Tày-Nùng	Tay-Nungf	Tày-Nùng	Tay-Nùng
Tày-Thái	Tay-Thais	Tày-Thái	Tay-Thái
tắc-te	tawc-tes	tắc-te	tăc-té
tắc-tích	tawc-tichs	tắc-tích	tăc-tích
tắc-xê	tawc-xees	tắc-xê	tăc-xế
tắc-xi	tawc-xis	tắc-xi	tăc-xí
tăcxi	tawcxi	tăcxi	tẵci
tănggô	tawnggoo	tănggô	tănggoo
tăngsê	tawngsee	tăngsê	tắngee
Tbuăn	Tbuawn	Tbuăn	Tbuawn
tđd	tddd	tđd	tdd
téc-gan	tec-gans	téc-gan	tec-gán
téc-mốt	tec-moots	téc-mốt	tec-mốt
ter	ter	ter	tẻ
test	test	test	tét
tetracyclin	tetracyclin	tetracyclin	tẻtacyclin
têtanôt	teetanoot	têtanôt	têtanoot
tích-kê	tich-kees	tích-kê	tich-kế
tích-tắc	tich-tawcs	tích-tắc	tich-tắc
tichkê	tichkee	tichkê	tichkee
tigôn	tigoon	tigôn	tigoon
tipô	tipoo	tipô	tipoo
tít-xuy	tit-xuys	tít-xuy	tit-xuý
tò-he	to-hef	tò-he	to-hè
toóc	toocs	toóc	tốc
toóc-si	tooc-sis	toóc-si	tôc-sí
tốc-kê	tooc-kees	tốc-kê	tôc-kế
tôngđơ	toongddow	tôngđơ	tôngđow
tônô	toonoo	tônô	tônoo
Tơ-đrá	Tow-ddras	Tơ-đrá	Tơ-đras
tờ-ra-côm	tow-ra-coomf	tờ-ra-côm	tơ-ra-cồm
tờ-ram	tow-ramf	tờ-ram	tơ-ràm
tờ-rắc	tow-rawcs	tờ-rắc	tơ-rắc
tờ-răng-xi-to	tow-rawng-xi-tof	tờ-răng-xi-to	tơ-răng-xi-tò
tờ-ren-cốt	tow-ren-coots	tờ-ren-cốt	tơ-ren-cốt
tờ-rô	tow-roof	tờ-rô	tơ-rồ
tờ-rớt	tow-rowts	tờ-rớt	tơ-rớt
tơrơt	towrowt	tơrơt	tởt
tơrưng	towruwng	tơrưng	tơửng
transistor	transistor	transistor	tránistor
trust	trust	trust	trút
tú-xơn	tu-xowns	tú-xơn	tu-xớn
tulơkhơ	tulowkhow	tulơkhơ	tulowkhow
tùng-bê	tung-beef	tùng-bê	tung-bề
tuốc-bin	tuooc-bins	tuốc-bin	tuôc-bín
tuốc-năng	tuooc-nawngs	tuốc-năng	tuôc-nắng
tuốc-nơ-vít	tuooc-now-vits	tuốc-nơ-vít	tuôc-nơ-vít
tuôcnăng	tuoocnawng	tuôcnăng	tuôcnawng
turbin	turbin	turbin	tủbin
tút-xuỵt	tut-xuytj	tút-xuỵt	tut-xuỵt
tuyếc-bin	tuyeec-bins	tuyếc-bin	tuyêc-bín
tuýp	tuyps	tuýp	tuyps
tuýt-xo	tuyt-xos	tuýt-xo	tuyt-xó
TW	TW	TW	TƯ
ủ-su	u-sur	ủ-su	u-sủ
Uar	Uar	Uar	Ủa
UPS	UPS	UPS	ÚP
upsilon	upsilon	upsilon	úpilon
urani	urani	urani	uảni
urê	uree	urê	uể
USD	USD	USD	ÚD
uýt-xki	uyt-xkis	uýt-xki	uyt-xkis
vác-xin	vac-xins	vác-xin	vac-xín
vacxin	vacxin	vacxin	vãcin
vagông	vagoong	vagông	vagoong
varơi	varowi	varơi	vaởi
vaselin	vaselin	vaselin	vaélin
vazơlin	vazowlin	vazơlin	vazowlin
vắc-xanh	vawc-xanhs	vắc-xanh	văc-xánh
vắc-xin	vawc-xins	vắc-xin	văc-xín
véc-ni	vec-nis	véc-ni	vec-ní
véc-tơ	vec-tows	véc-tơ	vec-tớ
vẹc-ni	vec-nij	vẹc-ni	vec-nị
verst	verst	verst	vét
vét-tông	vet-toongs	vét-tông	vet-tống
vét-xi	vet-xis	vét-xi	vet-xí
vettông	vettoong	vettông	vettoong
vetxi	vetxi	vetxi	vẽti
vi-scô	vi-scoo	vi-scô	vi-scoo
vi-xcô	vi-xcoo	vi-xcô	vi-xcoo
video-casset	video-casset	video-casset	video-caset
Việt-Mường	Vieet-Muwowngf	Việt-Mường	Viêt-Mường
vinilông	viniloong	vinilông	viniloong
viôlông	viooloong	viôlông	viôloong
viôlôngxen	viooloongxen	viôlôngxen	viôloongxen
virus	virus	virus	víu
visa	visa	visa	vía
visco	visco	visco	víco
vitcô	vitcoo	vitcô	vitcoo
vixcô	vixcoo	vixcô	vĩcoo
vonfram	vonfram	vonfram	vỏnam
voọc	voocj	voọc	vộc
vôlăng	voolawng	vôlăng	vôlawng
xà-beng	xa-bengf	xà-beng	xa-bèng
xà-bông	xa-boongf	xà-bông	xa-bồng
xà-cột	xa-cootj	xà-cột	xa-cột
xà-ích	xa-ichs	xà-ích	xa-ích
xà-lách	xa-lachs	xà-lách	xa-lách
xà-lách-xon	xa-lach-xons	xà-lách-xon	xa-lach-xón
xà-lan	xa-lanf	xà-lan	xa-làn
xà-lim	xa-limf	xà-lim	xa-lìm
xà-lỏn	xa-lonr	xà-lỏn	xa-lỏn
xà-lù	xa-luf	xà-lù	xa-lù
xà-phòng	xa-phongf	xà-phòng	xa-phòng
xabôchê	xaboochee	xabôchê	xaboochee
xác-ca-rin	xac-ca-rins	xác-ca-rin	xac-ca-rín
xác-đin	xac-ddins	xác-đin	xac-đín
xalông	xaloong	xalông	xaloong
xamôva	xamoova	xamôva	xamoova
xắc-cốt	xawc-coots	xắc-cốt	xăc-cốt
xéc-măng	xec-mawngs	xéc-măng	xec-mắng
xéc-ti-phi-ca	xec-ti-phi-cas	xéc-ti-phi-ca	xec-ti-phi-cá
xẹc-ti-phi-ca	xec-ti-phi-caj	xẹc-ti-phi-ca	xec-ti-phi-cạ
xenlô	xenloo	xenlô	xenloo
xerenat	xerenat	xerenat	xểnat
xêri	xeeri	xêri	xểi
xi-béc-nê-tích	xi-bec-nee-tichs	xi-béc-nê-tích	xi-bec-nê-tích
xì-căng-đan	xi-cawng-ddanf	xì-căng-đan	xi-căng-đàn
xì-cút	xi-cuts	xì-cút	xi-cút
xì-gà	xi-gaf	xì-gà	xi-gà
xì3	xi3f	xì3	xi3f
xích-đông	xich-ddoongs	xích-đông	xich-đống
xích-lô	xich-loos	xích-lô	xich-lố
xichlô	xichloo	xichlô	xichloo
xifông	xifoong	xifông	xiồng
ximăng	ximawng	ximăng	ximawng
xinê	xinee	xinê	xinee
xiphông	xiphoong	xiphông	xiphoong
xirô	xiroo	xirô	xiổ
xít-đờ-ca	xit-ddow-caf	xít-đờ-ca	xit-đơ-cà
xốp-phơ	xoop-phows	xốp-phơ	xôp-phớ
xôviêt	xoovieet	xôviêt	xôvieet
Xrê	Xree	Xrê	Xree
xtăng-xin	xtawng-xin	xtăng-xin	xtawng-xin
xtê-rê-ô	xtee-ree-oo	xtê-rê-ô	xtee-rê-ô
Xtiêng	Xtieeng	Xtiêng	Xtieeng
xtốp	xtoops	xtốp	xtoops
xtơ-rết	xtow-reets	xtơ-rết	xtow-rết
xtrép-tô-mi-xin	xtrep-too-mi-xins	xtrép-tô-mi-xin	xtrep-tô-mi-xín
xtrết	xtreets	xtrết	xtreets
xtrích-nin	xtrich-nins	xtrích-nin	xtrich-nín
xú-báp	xu-baps	xú-báp	xu-báp
xú-páp	xu-paps	xú-páp	xu-páp
xú-ve	xu-ves	xú-ve	xu-vé
xú-vơ-nia	xu-vow-nias	xú-vơ-nia	xu-vơ-nía
xúc-xích	xuc-xichs	xúc-xích	xuc-xích
xuchiêng	xuchieeng	xuchiêng	xuchieeng
xúp-de	xup-des	xúp-de	xup-dé
yard	yard	yard	yảd
yôga	yooga	yôga	yooga
